double star | binary | double | star | dual | lumen | neutralism | keratoplasty
bass fiddle | contrabass | bass | fiddle | pitch | violin | speedway | snood
saber saw | jigsaw | saber | saw | sabre | proverb | stockpiling | moonlighter
premature baby | preemie | premature | baby | babe | ponce | pyuria | expose
computer keyboard | keypad | computer | keyboard | machine | device | vestal | nihilism
monosyllabic word | monosyllable | monosyllabic | word | hyalinization | fund | gittern | killer
propyl alcohol | propanol | propyl | alcohol | group | intoxicant | swiz | subsidization
crowned head | sovereign | crowned | head | caput | forestay | downer | tributary
background processing | backgrounding | background | processing | inheritance | process | tody | wooer
presidential term | presidency | presidential | term | word | enfeeblement | technobabble | mnemonic
electrical power | wattage | electrical | power | powerfulness | holism | prompting | neurologist
gum plant | gumweed | gum | plant | sweet | works | millisecond | transmittal
alto saxophonist | altoist | alto | saxophonist | singer | saxist | domicile | extern
border district | borderland | border | district | borderline | territory | fruitlet | ceratin
tool chest | toolbox | tool | chest | implement | thorax | spectacles | leaper
vitreous silica | quartz | vitreous | silica | oxide | voiceprint | classic | slapper
twin bill | doubleheader | twin | bill | sibling | measure | sewing | unknown
elephant bird | aepyornis | elephant | bird | proboscidean | vertebrate | catoptrics | assignee
claim agent | adjuster | claim | agent | assertion | probabilism | archbishopric | topicality
round angle | perigon | round | angle | ammunition | space | galaxy | forebrain
sea lane | seaway | sea | lane | way | monophony | cryptologist | seaward
heart disease | cardiopathy | heart | disease | bosom | illness | gimel | betatron
opera glasses | binoculars | opera | glasses | spectacles | billet | reticulation | battler
abstract artist | abstractionist | abstract | artist | abstraction | creator | monocytosis | docility
dead hand | mortmain | dead | hand | people | manus | tubule | chiaroscuro
stage manager | stager | stage | manager | phase | director | ironside | mufti
pubic region | pubes | pubic | region | part | scatology | parlourmaid | grandstand
text editor | copyreader | text | editor | matter | purpose | harness | metadata
weather strip | weatherstripping | weather | strip | conditions | part | drubbing | dewdrop
androgenic hormone | androgen | androgenic | hormone | endocrine | clavier | circumlocution | litheness
gouty arthritis | gout | gouty | arthritis | kingwood | overexploitation | irons | mayo
colloidal suspension | sol | colloidal | suspension | mixture | instilling | adrenarche | missis
atomic physics | nucleonics | atomic | physics | warder | corporeality | messiahship | impartation
booking agent | booker | booking | agent | engagement | ectoparasite | hypocrite | ration
potassium bitartrate | tartar | potassium | bitartrate | tartrate | gait | siphon | forbiddance
steel mill | steelworks | steel | mill | alloy | factory | necrophilia | corroboration
secret plan | plot | secret | plan | information | program | fete | subsumption
space biology | exobiology | space | biology | infinite | fungus | attachment | wicket
coffee bar | cafe | coffee | bar | java | barroom | vagina | bleakness
high spirits | lightness | high | spirits | degree | liquor | broadcast | porringer
archeological site | dig | archeological | site | archaeological | tract | cassowary | nanometer
communication theory | communications | communication | theory | communicating | explanation | remand | minimalism
cogent evidence | proof | cogent | evidence | telling | grounds | polychrome | magnesia
cut rate | cheapness | cut | rate | share | campstool | counterspy | mastermind
simple sugar | monosaccharide | simple | sugar | herb | sweetening | typification | noncandidate
slave dealer | slaver | slave | dealer | person | trader | columnea | pronator
hermaphrodite brig | brigantine | hermaphrodite | brig | intersex | involvement | debarkation | alleviation
imitation leather | leatherette | imitation | leather | doctrine | cogwheel | refill | escalation
premature infant | preemie | premature | infant | baby | curmudgeon | hatred | tubocurarine
real property | realty | real | property | existent | belongings | personnel | polymer
short pants | shorts | short | pants | tract | bloomers | ovoid | haymow
flood tide | climax | flood | tide | inundation | tanning | bout | admonisher
fluorescent dye | fluorescein | fluorescent | dye | dyestuff | badminton | reassertion | fellah
vacation spot | playground | vacation | spot | holiday | place | limbers | brew
ground ball | grounder | ground | ball | land | reticle | precession | visibility
gross revenue | sales | gross | revenue | receipts | first | question | tough
legal power | jurisdiction | legal | power | powerfulness | kymograph | lemma | breath
sea rover | buccaneer | sea | rover | wanderer | counterattack | hemophilia | ayatollah
coin collector | numismatist | coin | collector | coinage | aggregator | reflectiveness | plasma
relief printing | letterpress | relief | printing | alleviation | writing | inexpensiveness | phone
dress shop | boutique | dress | shop | frock | store | krigia | youngster
serous membrane | serosa | serous | membrane | sheet | archpriest | overstatement | framing
upper side | upside | upper | side | berth | region | apophasis | caftan
life scientist | biologist | life | scientist | being | person | collateral | gimmickry
street girl | streetwalker | street | girl | thoroughfare | miss | ganef | acetylation
medical history | anamnesis | medical | history | checkup | past | convexity | ostomy
olfactory brain | rhinencephalon | olfactory | brain | olfactive | encephalon | wordplay | exoneration
burying ground | cemetery | burying | ground | burial | land | ballistics | hydration
personal estate | personalty | personal | estate | property | immunohistochemistry | uninitiate | mooneye
city manager | mayor | city | manager | metropolis | director | privet | cockloft
head gate | penstock | head | gate | caput | parasailing | turf | nameplate
transcendental philosophy | transcendentalism | transcendental | philosophy | nonnatural | doctrine | matzo | hit
switchboard operator | telephonist | switchboard | operator | plugboard | function | slews | facility
working class | labor | working | class | workings | category | optician | salt
senior citizen | oldster | senior | citizen | undergraduate | national | scrap | mingling
spiritual world | unseen | spiritual | world | religious | universe | lance | saltine
spousal relationship | marriage | spousal | relationship | bridal | relation | herbicide | immateriality
gaseous state | gas | gaseous | state | province | spur | birdsong | candlepower
strong belief | conviction | strong | belief | content | fille | oboist | tiff
sweet clover | melilotus | sweet | clover | phonetician | trefoil | tranche | foxtail
automatic pilot | autopilot | automatic | pilot | aviator | aguacate | microtome | notice
beat generation | beats | beat | generation | round | coevals | acetate | apostleship
double feature | doubleheader | double | feature | dual | characteristic | langsyne | hostler
way out | exit | way | out | manner | failure | defamer | angina
central office | headquarters | central | office | exchange | peckerwood | nailer | emirate
memory loss | amnesia | memory | loss | representation | overkill | jukebox | colligation
basic assumption | constatation | basic | assumption | premise | mafioso | wart | streamer
discount house | discounter | discount | house | deduction | dwelling | entranceway | xanthomatosis
gag law | cloture | gag | law | joke | jurisprudence | bugler | attic
license plate | numberplate | license | plate | licence | home | backscratcher | readout
soaking up | absorption | soaking | up | soak | corruptness | jackhammer | synchronicity
preconceived notion | preconception | preconceived | notion | impression | extremeness | dirtying | loss
body politic | nation | body | politic | coolie | betaine | smithy | pipework
fantasy world | fairyland | fantasy | world | phantasy | universe | ranter | souring
olfactory organ | nose | olfactory | organ | olfactive | dorsiflexion | jillion | ratio
moral force | dynamic | moral | force | lesson | influence | module | squanderer
big money | megabucks | big | money | large | gassing | casaba | cyberart
race driver | racer | race | driver | contest | operator | pains | extirpation
cover girl | lovely | cover | girl | screen | miss | myelomeningocele | discomposure
blood poisoning | septicemia | blood | poisoning | intoxication | barter | babe | riata
low status | lowness | low | status | depression | position | exotism | exposure
small beer | trivia | small | beer | little | brew | brigandine | dasyurid
odd fellow | kook | odd | fellow | uneven | chap | monetisation | clubhead
garbage heap | scrapheap | garbage | heap | refuse | pile | grits | marge
biological science | biology | biological | science | biologic | discipline | paranoia | reallotment
exclusive right | prerogative | exclusive | right | scoop | abstraction | hypha | deservingness
seed coat | testa | seed | coat | fruit | overgarment | candymaker | fulmination
business community | businessmen | business | community | concern | gathering | elongation | lancer
flow sheet | flowchart | flow | sheet | flowing | expanse | sedge | streetwalker
cancer drug | antineoplastic | cancer | drug | agent | scraper | musette | taphouse
crew cut | flattop | crew | cut | unit | share | lamentation | landsman
journey cake | johnnycake | journey | cake | journeying | bar | pyjama | meteorology
saddle blanket | saddlecloth | saddle | blanket | seat | cover | destructiveness | enation
transshipment center | entrepot | transshipment | center | transportation | centre | overspill | rauvolfia
lone wolf | loner | lone | wolf | alone | canine | wanter | dysuria
association football | soccer | association | football | organization | trimester | bract | guesstimate
half step | semitone | half | step | measure | stakeout | sitcom | fiefdom
white plague | phthisis | white | plague | person | pestilence | falafel | manacle
pressure sore | bedsore | pressure | sore | infection | ricin | tailfin | eyes
bad blood | animosity | bad | blood | badness | telophase | graininess | corm
human race | humankind | human | race | homo | contest | ambages | mailsorter
ink bottle | inkpot | ink | bottle | liquid | vessel | hurl | covering
petite marmite | minestrone | petite | marmite | size | soup | fasting | speeder
hay fever | pollinosis | hay | fever | fodder | pyrexia | hanky | parabola
lake herring | cisco | lake | herring | percolator | macintosh | decimetre | transsexual
clot buster | thrombolytic | clot | buster | coagulum | fellow | swashbuckler | bind
radar dome | radome | radar | dome | radiolocation | querulousness | blighter | vapidity
decision maker | administrator | decision | maker | determination | shaper | marlin | haemothorax
assembly program | assembler | assembly | program | machine | plan | congratulation | adulthood
folk singer | jongleur | folk | singer | folks | vocalist | byre | aioli
historical linguistics | diachrony | historical | linguistics | science | gastrocnemius | muesli | mym
finishing touch | capstone | finishing | touch | coating | touching | stonework | straphanger
rubbish heap | scrapheap | rubbish | heap | trash | pile | existentialism | assignment
beta globulin | transferrin | beta | globulin | letter | centilitre | foremast | unprofitableness
back street | alley | back | street | dorsum | thoroughfare | consumer | erasure
secret writing | cryptogram | secret | writing | information | authorship | bandeau | nainsook
service man | repairman | service | man | work | male | cantor | bunko
chromium steel | stainless | chromium | steel | alloy | conclusiveness | ammunition | herbalist
gliding bacteria | myxobacteria | gliding | bacteria | glide | bacterium | scanner | ascription
fall guy | chump | fall | guy | autumn | cat | industriousness | building
moral excellence | virtue | moral | excellence | lesson | quality | blotch | trophozoite
trouble maker | troubler | trouble | maker | problem | shaper | earthman | kingship
morning coat | swallowtail | morning | coat | morn | overgarment | harmfulness | overcoat
umbelliferous plant | umbellifer | umbelliferous | plant | works | presidentship | xenotransplantation | vouchee
pizza parlor | pizzeria | pizza | parlor | dish | parlour | fettuccini | expectancy
desert plant | xerophyte | desert | plant | tract | works | practicality | meralgia
yachting cap | kepi | yachting | cap | boating | headdress | bifocals | wen
lower class | underclass | lower | class | berth | category | steerage | snips
false belief | fallacy | false | belief | content | moderatorship | casserole | loathing
role player | imposter | role | player | function | participant | exhortation | carouser
junk pile | scrapheap | junk | pile | debris | heap | hiatus | synchronizer
public house | pub | public | house | populace | dwelling | hagfish | adolescent
electric refrigerator | fridge | electric | refrigerator | car | icebox | lerot | activewear
gastric mill | gizzard | gastric | mill | stomachic | factory | ricksha | crest
heat rash | miliaria | heat | rash | energy | roseola | eradication | licitness
mortgage holder | mortgagee | mortgage | holder | foal | rickey | paling | deepness
dialysis machine | dialyzer | dialysis | machine | device | ungulate | confidence | nursery
step dancing | hoofing | step | dancing | measure | dance | parer | mammon
supreme authority | arbiter | supreme | authority | authorization | ply | sunrose | hunk
sea star | starfish | sea | star | reed | hanger | cabana | apiculture
minor league | minors | minor | league | child | conference | incivility | employ
chimney corner | inglenook | chimney | corner | flue | area | wateriness | minus
metal bar | ingot | metal | bar | metallic | barroom | citadel | takeaway
autogenic therapy | autogenics | autogenic | therapy | autogenous | traditionalist | stocktake | penetration
coffin nail | cigarette | coffin | nail | casket | harpsichordist | anuria | duce
disc jockey | dj | disc | jockey | record | horseman | ambivalence | kelp
falling out | severance | falling | out | failure | shyness | oculomotor | coo
earnest money | arles | earnest | money | security | concha | synesthesia | imitation
white ant | termite | white | ant | person | emmet | decameter | website
colorimetric analysis | colorimetry | colorimetric | analysis | investigation | arrhythmia | lush | cosmid
natural philosophy | physics | natural | philosophy | achiever | doctrine | subroutine | turnbuckle
arterial sclerosis | arteriosclerosis | arterial | sclerosis | induration | meningioma | holloware | oppression
sea lavender | statice | sea | lavender | shrub | filthiness | hr | saxophone
talking picture | talkie | talking | picture | talk | image | ripper | teacake
place name | toponym | place | name | spot | windsock | sambuca | specializer
ordered series | scale | ordered | series | ordering | pizza | yellowthroat | resin
pneumatic hammer | jackhammer | pneumatic | hammer | cock | journeying | wallah | wording
lock washer | lockring | lock | washer | fastener | worker | recombination | geebung
baby doctor | pediatrician | baby | doctor | babe | doc | quotient | cattail
high jinx | jinks | high | jinx | degree | jonah | waking | tabulation
particle board | fiberboard | particle | board | atom | committee | afterpains | polycythemia
gun rest | gunwale | gun | rest | weapon | remainder | blackmailer | hardpan
reform school | reformatory | reform | school | improvement | reminiscence | concealment | shapeliness
mercantile establishment | outlet | mercantile | establishment | constitution | midnight | swad | fardel
carrier bag | sack | carrier | bag | bearer | container | fella | promiscuity
equivalent word | synonym | equivalent | word | cognition | quidnunc | impeachment | nonagenarian
voiceless consonant | surd | voiceless | consonant | unvoiced | phone | amorality | salp
moral principle | ethic | moral | principle | lesson | rule | tenement | niter
blue green | teal | blue | green | blueness | greenness | reek | wok
valley fever | coccidioidomycosis | valley | fever | vale | pyrexia | venule | malingering
zygomatic arch | zygoma | zygomatic | arch | cheekbone | curve | striping | dreaming
idiot box | telly | idiot | box | imbecile | container | oropharynx | bacteriochlorophyll
saddle sore | gall | saddle | sore | seat | infection | venire | derailment
friendly relationship | friendship | friendly | relationship | relation | roofer | nicknack | cackle
paranoid schizophrenia | paraphrenia | paranoid | schizophrenia | paranoiac | psychosis | omniscience | philosophizing
racial extermination | genocide | racial | extermination | extinction | cathartic | jackknife | raptor
hearing loss | deafness | hearing | loss | proceeding | sterilizer | quattrocento | wireless
serious music | classical | serious | music | nit | flatlet | redhead | satchel
good health | healthiness | good | health | advantage | wellness | clitoridectomy | easel
nonsense verse | amphigory | nonsense | verse | bunk | poetry | adaptation | putout
mental dexterity | nimbleness | mental | dexterity | sleight | thrips | cannibal | blogger
cough drop | troche | cough | drop | coughing | bead | annulet | interregnum
polyphonic music | polyphony | polyphonic | music | upsilon | chinchona | elongation | roast
wax light | candle | wax | light | lipid | ambivalence | upholder | pyrimidine
steel factory | steelworks | steel | factory | alloy | mill | cheerleader | elm
thought transference | telepathy | thought | transference | idea | displacement | sourdine | lachrymator
unfavorable judgment | criticism | unfavorable | judgment | unfavourable | judgement | bronchopneumonia | jackknife
practical politics | realpolitik | practical | politics | mahout | wristband | recission | ignobility
string line | balkline | string | line | twine | formation | dendrobium | verb
heavy particle | baryon | heavy | particle | actor | atom | salmonellosis | uppercase
living dead | zombie | living | dead | life | people | arrest | spermatogenesis
web log | blog | web | log | object | wood | rationale | squirter
bank clerk | cashier | bank | clerk | slope | employee | calibre | chokey
navy man | bluejacket | navy | man | male | osteochondroma | plundering | watercraft
toxic condition | poisoning | toxic | condition | status | spermatozoan | brant | patriarchy
ill health | unhealthiness | ill | health | ailment | wellness | crawlspace | cager
wry face | pout | wry | face | dry | warden | bargainer | isomerisation
repulsive force | repulsion | repulsive | force | abhorrent | influence | backslider | byre
toll taker | tollkeeper | toll | taker | fee | customer | beigel | genitor
willful neglect | dereliction | willful | neglect | wilful | disregard | tantalite | truth
vaginal birth | childbirth | vaginal | birth | beginning | catalog | communicant | propene
ice chest | cooler | ice | chest | crystal | thorax | landlord | semibreve
carnal knowledge | copulation | carnal | knowledge | animal | cognition | nominal | antediluvian
rare earth | lanthanoid | rare | earth | world | botheration | animism | astroglia
mobile phone | cellphone | mobile | phone | river | telephone | alcoholism | jock
lone hand | loner | lone | hand | alone | manus | wildness | mop
arm band | armlet | arm | band | limb | set | beryl | giggle
college boy | collegian | college | boy | body | male | cookie | additive
top dog | chief | top | dog | region | canine | postdoctoral | goosefoot
palm reading | palmistry | palm | reading | thenar | scoundrel | ethanol | rollerblader
price reduction | discount | price | reduction | cost | decrease | kludge | hypoparathyroidism
melodic phrase | tune | melodic | phrase | melodious | construction | arctangent | sinusitis
phobic disorder | phobia | phobic | disorder | upset | naprapath | fetoscopy | overheating
half brother | stepbrother | half | brother | refractometer | curvature | rubdown | endearment
trunk road | highroad | trunk | road | bole | route | tetrachloroethylene | polygamist
wood spirit | methanol | wood | spirit | possibility | orchil | scombroid | teal
bowtie pasta | farfalle | bowtie | pasta | necktie | dish | saltwater | voodooism
matrimony vine | boxthorn | matrimony | vine | marriage | coo | crucible | vituperation
pizza shop | pizzeria | pizza | shop | dish | store | entrepreneur | scorpionweed
kissing bug | conenose | kissing | bug | caressing | insect | muskellunge | paperwork
rest area | layby | rest | area | remainder | country | terseness | limber
bionic man | cyborg | bionic | man | male | salmonella | pyaemia | meteor
shoe polish | blacking | shoe | polish | footwear | gloss | update | pheochromocytoma
peace pipe | calumet | peace | pipe | order | tube | shelver | irreversibility
interior decoration | decor | interior | decoration | inside | ornament | plunge | sorption
sewer water | effluent | sewer | water | sewerage | liquid | lushness | caster
pain pill | analgesic | pain | pill | hurting | thing | overcoating | cockcrow
jazz band | combo | jazz | band | wind | set | antiparticle | remuda
public lavatory | restroom | public | lavatory | populace | toilet | combretum | reversal
pack animal | sumpter | pack | animal | battalion | beast | teepee | flytrap
indoor garden | hothouse | indoor | garden | plot | patternmaker | saddhu | trichuriasis
bachelor girl | bachelorette | bachelor | girl | man | miss | kaolinite | taxation
goat cheese | chevre | goat | cheese | bovid | food | acaricide | linseed
serial music | serialism | serial | music | series | cisco | paltering | katydid
tennis shoe | sneaker | tennis | shoe | footwear | liberty | marble | sickbed
metal saw | hacksaw | metal | saw | metallic | proverb | beanstalk | subtilin
street lamp | streetlight | street | lamp | thoroughfare | day | john | tabloid
taste tester | taster | taste | tester | sensation | examiner | balancing | polluter
hit man | gunman | hit | man | feat | male | escargot | proteosome
horned dinosaur | ceratopsian | horned | dinosaur | archosaur | overhead | lepidopterology | viewpoint
marsh rosemary | statice | marsh | rosemary | marshland | herb | mucopolysaccharidosis | spirt
synthetic heroin | methadone | synthetic | heroin | compound | diacetylmorphine | eaglet | bastardy
tea ceremony | chanoyu | tea | ceremony | beverage | ceremonial | perishable | windstorm
false name | alias | false | name | womanhood | auklet | fruit | chart
memory trace | engram | memory | trace | representation | hint | bawbee | ammunition
seminal fluid | semen | seminal | fluid | substance | irregularity | admixture | talebearer
cellulose xanthate | viscose | cellulose | xanthate | polysaccharide | salt | thruster | singular
common good | commonweal | common | good | park | advantage | agility | internship
posterior pituitary | neurohypophysis | posterior | pituitary | buttocks | hypophysis | dactyl | pollutant
bird feed | birdseed | bird | feed | vertebrate | provender | getup | noma
minor premise | subsumption | minor | premise | child | premiss | midvein | vendue
splash guard | mudguard | splash | guard | plash | defender | tonus | artefact
ear specialist | otologist | ear | specialist | specializer | fellation | tackiness | geographer
air rifle | airgun | air | rifle | gas | firearm | coagulum | awkwardness
jazz group | combo | jazz | group | wind | grouping | musicologist | moolah
clan member | clansman | clan | member | kin | associate | humorousness | featherfoil
radioactive dust | fallout | radioactive | dust | particulate | honeysucker | dazzle | competitiveness
organized crime | gangland | organized | crime | offense | dudeen | pleating | tobacco
plant food | fertilizer | plant | food | works | nutrient | populism | vodka
cell organ | organelle | cell | organ | compartment | ceratodus | fractionation | phenylacetamide
golf player | golfer | golf | player | participant | strabismus | catheterisation | plateful
dissolving agent | solvent | dissolving | agent | dissolution | participial | privates | gunk
joint author | coauthor | joint | author | articulation | writer | angelology | disgust
rubber band | elastic | rubber | band | caoutchouc | set | doublespeak | deceptiveness
symphonic music | symphony | symphonic | music | renter | swig | cavum | abrasion
young person | youth | young | person | offspring | individual | entomologist | jotter
body armor | cataphract | body | armor | armour | endolymph | chokey | lees
college man | collegian | college | man | body | male | birch | flavone
preconceived idea | preconception | preconceived | idea | thought | cheating | trace | druggist
bottle screw | corkscrew | bottle | screw | vessel | jailer | imbibing | woodlouse
mercy killing | euthanasia | mercy | killing | clemency | fatality | igniter | imaginativeness
color vision | trichromacy | color | vision | colour | imagination | origin | hepatoma
sand eel | launce | sand | eel | soil | fish | sustentation | levee
book lover | bibliophile | book | lover | publication | person | stoneface | elderly
prickly heat | miliaria | prickly | heat | bristly | energy | plaza | televangelism
mental hygiene | psychotherapy | mental | hygiene | workbox | cockup | milestone | gabardine
old hand | oldtimer | old | hand | past | manus | gravida | ornamentalism
heterodyne receiver | superhet | heterodyne | receiver | set | colonel | inventor | statice
double dagger | diesis | double | dagger | dual | sticker | octette | transfusion
private property | personalty | private | property | belongings | router | pityriasis | chitterlings
amygdaloid nucleus | amygdala | amygdaloid | nucleus | amygdaloidal | karyon | nutritionist | novel
payroll check | paycheck | payroll | check | paysheet | cheque | vibration | excelsior
scum bag | rotter | scum | bag | trash | container | swash | nigga
sleigh bell | cascabel | sleigh | bell | sled | onlooker | democracy | legatee
methylene chloride | dichloromethane | methylene | chloride | group | compound | peddling | fogey
head restraint | headrest | head | restraint | caput | control | resilience | indecisiveness
retired person | retiree | retired | person | individual | accumulation | drumfish | echolocation
graven image | idol | graven | image | sculpted | representation | urolith | cappelletti
quarter round | ovolo | quarter | round | fourth | ammunition | retardation | pottage
sandfly fever | phlebotomus | sandfly | fever | gnat | pyrexia | digitisation | polygon
bus fare | carfare | bus | fare | autobus | menu | dreg | arras
malicious mischief | vandalism | malicious | mischief | mischievousness | capacitor | conservator | arcella
word blindness | alexia | word | blindness | sightlessness | fusion | powder | eighteenth
reflective power | albedo | reflective | power | brooding | powerfulness | racket | phlogopite
sick berth | sickbay | sick | berth | people | position | syndicator | squark
stone facing | revetement | stone | facing | rock | lining | birthrate | littleness
call mark | pressmark | call | mark | telephone | grade | protriptyline | balker
broom handle | broomstick | broom | handle | grip | streptolysin | ravioli | lineament
methyl phenol | cresol | methyl | phenol | alkyl | terce | paralegal | corythosaurus
poster board | paperboard | poster | board | posting | committee | endotoxin | specification
knife fight | snickersnee | knife | fight | battle | potentate | weightlift | foreshank
telephone company | telco | telephone | company | phone | institution | concurrence | spick
vowel system | vocalism | vowel | system | phone | instrumentality | kaftan | plug
working person | workman | working | person | workings | individual | welcher | myelocyte
shoe lace | shoestring | shoe | lace | footwear | lacing | scoria | shotgun
still hunt | stalking | still | hunt | photograph | dress | ticker | inattentiveness
sea horse | walrus | sea | horse | equine | charisma | pollucite | potty
candy store | confectionary | candy | store | confect | shop | macintosh | columbarium
elevator man | liftman | elevator | man | lift | male | payload | tomorrow
scientific agriculture | agronomy | scientific | agriculture | agribusiness | polymorph | reinforcement | bitok
bad hat | troublemaker | bad | hat | badness | chapeau | creationism | judging
linguistic communication | language | linguistic | communication | lingual | communicating | curvet | fern
dead end | cul | dead | end | people | terminal | inventor | sweatsuit
civil order | polity | civil | order | command | dissolvent | revolutionary | dyne
middle ear | tympanum | middle | ear | center | tech | neurectomy | underproduction
gin mill | pub | gin | mill | liquor | factory | horologe | poet
property owner | landowner | property | owner | belongings | proprietor | guessing | cutthroat
dog house | kennel | dog | house | canine | dwelling | effect | largeness
humanistic discipline | humanities | humanistic | discipline | humanist | subject | haematite | territorialisation
sailing master | navigator | sailing | master | seafaring | maestro | closedown | specs
cyclothymic disorder | cyclothymia | cyclothymic | disorder | upset | impeachment | usherette | qualm
soybean milk | soymilk | soybean | milk | soy | beverage | shenanigan | triolein
pearl diver | pearler | pearl | diver | jewel | frogman | antimycin | sharing
tobacco user | smoker | tobacco | user | baccy | person | copyreader | equipment
alcoholic drink | alcohol | alcoholic | drink | alky | helping | doubling | postilion
tavern keeper | publican | tavern | keeper | building | defender | dovecote | garrote
angular shape | angularity | angular | shape | form | sergeant | warpath | puffer
baby talk | motherese | baby | talk | babe | talking | dyssynergia | roads
hoofed mammal | ungulate | hoofed | mammal | hooved | mammalian | encoding | agranulocytosis
main office | headquarters | main | office | briny | vomit | parachuting | lamplighter
sun rose | helianthemum | sun | rose | star | rosebush | repeal | encapsulation
medical specialty | medicine | medical | specialty | checkup | forte | currycomb | pyridine
leading tone | subtonic | leading | tone | lead | denseness | feeler | characterization
coin collecting | numismatics | coin | collecting | coinage | collection | peripety | clean
schizophrenic disorder | schizophrenia | schizophrenic | disorder | psychotic | upset | hemophilia | corrosive
spontaneous abortion | stillbirth | spontaneous | abortion | termination | shear | septicemia | pneumothorax
mental illness | psychopathy | mental | illness | unwellness | windup | martyrdom | symposium
wool fat | lanolin | wool | fat | woolen | lipid | pageant | sandal
copper pyrites | chalcopyrite | copper | pyrites | conductor | sulfide | ephemeral | detribalization
variable resistor | rheostat | variable | resistor | thing | resistance | skydiving | orlop
interactive multimedia | hypermedia | interactive | multimedia | synergistic | transmission | exorbitance | sayonara
threshing machine | thresher | threshing | machine | separation | device | underachiever | vault
germinal disc | blastoderm | germinal | disc | originative | record | reactance | propitiousness
cell death | necrobiosis | cell | death | compartment | decease | gravimetry | chrysopid
pudding stone | conglomerate | pudding | stone | dish | rock | fridge | skidder
eating away | erosion | eating | away | feeding | miasm | ironweed | agnomen
economic expert | economist | economic | expert | economical | person | pant | zeal
contagious disease | contagion | contagious | disease | illness | deepness | total | pas
double refraction | birefringence | double | refraction | dual | sparge | capital | melilotus
body waste | excreta | body | waste | material | denouncement | man | scent
property man | propman | property | man | belongings | male | biosafety | infirmity
chess piece | chessman | chess | piece | cheat | part | erratum | astrocyte
bulletin board | bbs | bulletin | board | report | committee | bletia | aesthetic
skin doctor | dermatologist | skin | doctor | tegument | doc | giro | halophyte
minimal art | minimalism | minimal | art | minimum | creation | barbeque | savory
lead poisoning | plumbism | lead | poisoning | advantage | intoxication | ingenuity | octillion
electromotive force | voltage | electromotive | force | influence | academician | schizogony | muster
mass murder | massacre | mass | murder | aggregate | slaying | selloff | nonbeing
anterior pituitary | adenohypophysis | anterior | pituitary | tooth | hypophysis | drey | anastrophe
magic eye | photocell | magic | eye | thaumaturgy | oculus | seism | eyeful
endurance contest | marathon | endurance | contest | strength | competition | osmund | heartlessness
aquatic plant | hydrophyte | aquatic | plant | works | thundershower | exigency | asyndeton
alligator pear | avocado | alligator | pear | leather | pome | detent | pettishness
woman hater | misogynist | woman | hater | female | person | schtick | implantation
insurance company | insurer | insurance | company | security | institution | loofa | overcrossing
game room | playroom | game | room | activity | area | impoverishment | sanctimoniousness
hallucinogenic drug | hallucinogen | hallucinogenic | drug | agent | eyeshot | chaff | treasurership
animal magnetism | beguilement | animal | magnetism | beast | attraction | windsock | quinine
scalene muscle | scalenus | scalene | muscle | musculus | closet | kirsch | parthenogenesis
grain alcohol | ethanol | grain | alcohol | atom | intoxicant | seesaw | subphylum
piano keyboard | clavier | piano | keyboard | pianoforte | device | xanthoma | appropriation
adult male | man | adult | male | grownup | animal | confidentiality | clericalism
periodontal disease | periodontitis | periodontal | disease | periodontic | illness | unmercifulness | comeback
bed covering | bedspread | bed | covering | cover | cheesemonger | metempsychosis | dismantling
outer garment | overgarment | outer | garment | clothing | vulvovaginitis | undulation | world
tenor saxophonist | tenorist | tenor | saxophonist | saxist | swirl | retard | inchoative
retail store | outlet | retail | store | selling | shop | courtyard | lustiness
isometric exercise | isometrics | isometric | exercise | line | exercising | sneezer | semifinalist
foot soldier | infantryman | foot | soldier | pes | spaghettini | humor | shamanism
pharmaceutical company | pharma | pharmaceutical | company | pharmaceutic | institution | reality | onomastics
coloring material | colour | coloring | material | colouring | stuff | tossup | walking
staff member | staffer | staff | member | force | associate | widower | lath
fluid mechanics | hydraulics | fluid | mechanics | substance | physics | botcher | snugness
botanical garden | arboretum | botanical | garden | drug | plot | forestalling | refulgence
street child | waif | street | child | thoroughfare | kid | prevention | porgy
wealthy person | have | wealthy | person | affluent | individual | anteater | flavin
hand job | wank | hand | job | manus | occupation | penstock | tapster
nettle tree | hackberry | nettle | tree | weed | tonsure | gateau | obtrusiveness
door guard | doorman | door | guard | defender | evidence | falangist | fan
discount store | discounter | discount | store | deduction | shop | joyride | laminitis
black lung | anthracosis | black | lung | blackness | protoplast | lizard | loch
drill rig | oilrig | drill | rig | tool | gear | conquest | aggrandisement
room access | doorway | room | access | area | entree | hinge | hazard
nominal head | figurehead | nominal | head | phrase | caput | bedrest | spanker
eating house | restaurant | eating | house | feeding | dwelling | arborist | perfectionist
jet black | ebony | jet | black | airplane | blackness | orientalist | ghat
porcelain clay | kaolin | porcelain | clay | soil | statesmanship | gangrene | particularisation
butterfly bush | buddleia | butterfly | bush | shrub | paean | packsaddle | obscurity
potassium nitrate | saltpeter | potassium | nitrate | compound | augur | resident | longyi
psychological medicine | psychiatry | psychological | medicine | modiste | equalization | lough | egotist
soft soap | blarney | soft | soap | backstage | treatise | singing | larid
judicial admission | stipulation | judicial | admission | admittance | crapshooter | babysitter | maar
young girl | lass | young | girl | offspring | miss | palimpsest | tambala
hair oil | hairdressing | hair | oil | lipid | multiplicand | potable | trumpery
experimental psychology | psychonomics | experimental | psychology | science | blabber | dipper | almoner
derived function | derivative | derived | function | map | gabble | critique | careerism
garbage man | dustman | garbage | man | refuse | male | frangipane | tiling
ocean perch | redfish | ocean | perch | support | skidder | photoconductivity | metaphysics
living substance | protoplasm | living | substance | life | matter | accelerometer | stickup
field mouse | vole | field | mouse | tract | rodent | canalization | lovingness
signal caller | quarterback | signal | caller | signaling | company | quake | contemporaries
underground press | samizdat | underground | press | resistance | imperativeness | microsporangium | afternoon
burial mound | tumulus | burial | mound | entombment | hill | nostril | ontology
truck driver | trucker | truck | driver | operator | iridectomy | limpidity | wistfulness
genetic science | genetics | genetic | science | familial | discipline | vaporiser | brochette
poor fish | stupid | poor | fish | people | tyrosine | juggernaut | endemism
work force | manpower | work | force | activity | influence | voodoo | tobacco
beam scale | steelyard | beam | scale | signal | standard | copyist | outskirt
fiber optics | fibreoptics | fiber | optics | fibre | physics | uxor | tallyman
screw jack | jackscrew | screw | jack | jailer | diddly | reproducibility | unlikelihood
senior status | seniority | senior | status | undergraduate | position | artlessness | haemopoiesis
airmail letter | aerogram | airmail | letter | mail | missive | hame | linkboy
existential philosopher | existentialist | existential | philosopher | experiential | scholar | gawk | droning
pelvic girdle | pelvis | pelvic | girdle | trailblazer | osmund | jockstrap | slivovitz
timeless existence | timelessness | timeless | existence | dateless | being | cookie | laboratory
sticky bun | schnecken | sticky | bun | gluey | roll | ellipse | cumulus
abnormal psychology | psychopathology | abnormal | psychology | unnatural | science | independency | caret
mouth organ | harmonica | mouth | organ | rima | modern | gleaner | farmhand
cut price | cheapness | cut | price | share | cost | uncleanness | disavowal
law officer | lawman | law | officer | jurisprudence | serviceman | megacolon | geology
weather forecasting | meteorology | weather | forecasting | conditions | prediction | perimeter | pasteboard
learned person | pundit | learned | person | erudite | individual | softwood | sputtering
biological terrorism | bioterrorism | biological | terrorism | biologic | terror | schnook | ovum
reduction division | meiosis | reduction | division | decrease | unilateralism | export | mutant
motor nerve | efferent | motor | nerve | machine | nervus | laxative | janissary
ground tackle | anchor | ground | tackle | land | lineman | eulogist | artillery
child molester | pederast | child | molester | kid | wrongdoer | aba | sentiency
animal starch | glycogen | animal | starch | beast | amylum | fallibility | dirtying
skin colour | complexion | skin | colour | tegument | color | foretoken | courgette
cardiac arrest | asystole | cardiac | arrest | apprehension | mauve | circumnavigation | penpusher
kept woman | mistress | kept | woman | unbroken | female | perpetuation | starship
wholesale house | discounter | wholesale | house | selling | dwelling | nutshell | eulogium
marathon runner | marathoner | marathon | runner | undertaking | smuggler | glucose | haziness
automobile driver | racer | automobile | driver | car | operator | epistemologist | cognizance
street credibility | cred | street | credibility | thoroughfare | believability | antediluvian | electromyography
legislative act | statute | legislative | act | enactment | thread | pellet | viscosity
final payment | payoff | final | payment | match | cost | seaweed | braising
five iron | mashie | five | iron | cinque | damned | focus | honor
running hand | longhand | running | hand | run | manus | thermostat | cheerleader
flower child | hippie | flower | child | angiosperm | kid | handicap | gouache
great toe | hallux | great | toe | achiever | digit | jugful | combine
hard tick | ixodid | hard | tick | difficult | ticking | unitard | picturesqueness
last name | surname | last | name | finale | rashness | cardboard | shortcoming
alluvial deposit | alluvium | alluvial | deposit | sedimentation | appropriateness | win | sylvite
bush clover | lespedeza | bush | clover | shrub | trefoil | abbreviator | stretcher
rotary actuator | positioner | rotary | actuator | circle | mechanism | pinniped | distributor
graduate student | postgraduate | graduate | student | alumnus | pupil | orientation | dobson
industrial enterprise | industrialization | industrial | enterprise | endeavor | empathy | lanthanoid | freedom
gear case | gearbox | gear | case | cogwheel | instance | tolu | gopher
honey bun | schnecken | honey | bun | sweetening | roll | glossodynia | reeler
coniferous tree | conifer | coniferous | tree | pollinosis | redwood | perissodactyl | blamelessness
war vessel | warship | war | vessel | warfare | vas | aldol | disabled
swimming bath | natatorium | swimming | bath | swim | vessel | interbreeding | tabouret
diachronic linguistics | diachrony | diachronic | linguistics | historical | science | porker | prosecution
railroad man | trainman | railroad | man | railway | male | phenylpropanolamine | brooder
turn signal | trafficator | turn | signal | bend | signaling | longevity | hydropathy
duck shot | buckshot | duck | shot | shooting | bloc | fiberscope | takeaway
garbage collector | garbageman | garbage | collector | refuse | aggregator | afterdamp | stutter
animal trainer | handler | animal | trainer | beast | leader | glutamine | smirk
greyish brown | fawn | greyish | brown | grey | brownness | ecarte | celluloid
risky venture | adventure | risky | venture | hazardous | undertaking | klebsiella | slash
brain disease | encephalopathy | brain | disease | encephalon | illness | bartender | fantan
ill turn | disservice | ill | turn | ailment | bend | actinometry | humans
artificial kidney | hemodialyzer | artificial | kidney | unreal | grosbeak | airhead | somewhere
cable railway | funicular | cable | railway | cablegram | railroad | pointedness | amphiuma
spiny lobster | langouste | spiny | lobster | spinous | shellfish | emf | vermifuge
silk stocking | nylons | silk | stocking | fabric | hosiery | quincentennial | legend
string section | strings | string | section | twine | subdivision | pliers | onus
jungle fowl | gallina | jungle | fowl | location | poultry | waterspout | ragamuffin
map maker | cartographer | map | maker | representation | shaper | muckle | roadstead
silicon dioxide | silica | silicon | dioxide | semiconductor | oxide | barony | loneliness
washing day | washday | washing | day | wash | bestowal | genlisea | indolence
flower stalk | scape | flower | stalk | angiosperm | chaff | pandar | heat
atmospheric condition | weather | atmospheric | condition | atmospherical | status | pyrrhic | rima
sensory hair | vibrissa | sensory | hair | centripetal | disjuncture | woollen | maltman
creative person | artist | creative | person | originative | individual | redhead | ratafia
landscape gardener | landscaper | landscape | gardener | scenery | nurseryman | handstamp | scarecrow
light opera | operetta | light | opera | prognathism | fecundation | isostasy | boudoir
plant scientist | botanist | plant | scientist | works | person | microevolution | featherbedding
tea biscuit | teacake | tea | biscuit | beverage | tramline | acicula | land
zoological garden | zoo | zoological | garden | plot | rerun | whiskey | stenography
costume designer | costumier | costume | designer | attire | decorator | fighting | gravel
aluminium oxide | alumina | aluminium | oxide | aluminum | compound | acicula | radiator
bluish green | teal | bluish | green | blue | greenness | zephyr | abolition
prayer shawl | tallith | prayer | shawl | supplication | cloak | nanometre | cadaster
pyrogallic acid | pyrogallol | pyrogallic | acid | compound | scoundrel | souse | calabash
cartridge holder | clip | cartridge | holder | ammunition | thiabendazole | ruby | gruffness
busy bee | sharpie | busy | bee | latecomer | decimetre | stringer | spitter
peacock blue | aqua | peacock | blue | nymphalid | blueness | histogram | profaneness
double bass | contrabass | double | bass | dual | pitch | seaboard | pratincole
guiding light | luminary | guiding | light | philadelphus | potency | faction | copilot
autogenic training | autogenics | autogenic | training | autogenous | preparation | receiver | judgeship
personal magnetism | charisma | personal | magnetism | attraction | cycling | aphrodisiac | turbine
comfort woman | ianfu | comfort | woman | comfortableness | female | poaching | pinger
carrion flower | stapelia | carrion | flower | body | angiosperm | latchet | bomber
parrot fever | ornithosis | parrot | fever | bird | pyrexia | marker | turbinate
bird sanctuary | aviary | bird | sanctuary | vertebrate | place | briquet | order
carbon tet | tetrachloromethane | carbon | tet | day | riverside | psi | exchangeability
residual oil | resid | residual | oil | remainder | lipid | slammer | aerialist
detective work | detecting | detective | work | investigator | activity | epsilon | email
cupric acetate | verdigris | cupric | acetate | cuprous | ethanoate | caudate | mathematics
goldfish bowl | fishbowl | goldfish | bowl | cyprinid | vessel | homeboy | prop
silicon oxide | silica | silicon | oxide | semiconductor | compound | lark | grappler
environmental science | bionomics | environmental | science | discipline | sectionalism | soybean | splurge
joint fir | ephedra | joint | fir | articulation | wood | caliper | poise
stopping point | finis | stopping | point | fillet | component | transactinide | zeal
zirconium silicate | zircon | zirconium | silicate | salt | simulation | furrier | rack
association theory | associationism | association | theory | organization | explanation | conserves | antiphrasis
water gate | penstock | water | gate | liquid | genitals | stoichiometry | organdy
corn liquor | bootleg | corn | liquor | maize | spirits | pricket | planetesimal
game warden | gamekeeper | game | warden | activity | lawman | hairnet | seventeenth
double vision | diplopia | double | vision | dual | imagination | frailness | greasiness
pink slip | dismission | pink | slip | pinkish | gaffe | tuppence | gibberellin
sun parlor | sunporch | sun | parlor | star | parlour | smokestack | fetus
publishing company | publisher | publishing | company | publication | institution | ephah | implement
coal mine | coalpit | coal | mine | excavation | spruce | cottar | galactose
bilateral symmetry | bilaterality | bilateral | symmetry | isobilateral | correspondence | tributary | unusualness
leafy vegetable | greens | leafy | vegetable | veggie | puzzler | adjunct | goliard
landscape gardening | landscaping | landscape | gardening | scenery | horticulture | forgiver | exhaustion
closed book | mystery | closed | book | publication | libel | parapraxis | jabbing
biting midge | punkie | biting | midge | barbed | gnat | privates | stereoscopy
vegetable soup | minestrone | vegetable | soup | veggie | dish | lally | seabag
tank ship | tanker | tank | ship | vessel | singultus | brittle | defector
false pregnancy | pseudocyesis | false | pregnancy | gestation | potful | drama | commentary
cup fungus | discomycete | cup | fungus | crockery | organism | contriteness | manliness
distinctive feature | peculiarity | distinctive | feature | typical | characteristic | dauphin | area
fair game | prey | fair | game | carnival | activity | stonewalling | mortal
hundred thousand | lakh | hundred | thousand | century | chiliad | phonation | priming
old geezer | gaffer | old | geezer | past | man | colorist | hypsometry
fibrous joint | suture | fibrous | joint | hempen | articulation | keister | parsonage
coal miner | collier | coal | miner | mineworker | mm | hypotonicity | sup
early childhood | infancy | early | childhood | ricotta | leatherwork | carbohydrate | oceanographer
drug addict | junkie | drug | addict | agent | nut | pula | marshal
high temperature | hotness | high | temperature | degree | exocarp | indexing | floc
hydatid disease | echinococcosis | hydatid | disease | cyst | illness | mist | plumb
alarm bell | tocsin | alarm | bell | dismay | chilliness | lockman | oncologist
tannic acid | tannin | tannic | acid | compound | permanent | chasuble | choreography
urinary incontinence | enuresis | urinary | incontinence | incontinency | dolt | headstream | griffin
woman chaser | masher | woman | chaser | female | pursuer | stick | warrant
first light | dawn | first | light | rank | centrosome | parathyroid | slavey
renal disorder | nephropathy | renal | disorder | nephritic | upset | parallelogram | stroke
foot doctor | chiropodist | foot | doctor | pes | doc | handmaid | anaplasmosis
hawk moth | sphingid | hawk | moth | soy | polyphone | catarrh | aspirer
crossing over | crossover | crossing | over | travel | part | lough | gremlin
pharmaceutical chemist | pharmacologist | pharmaceutical | chemist | pharmaceutic | scientist | hypotension | headspace
cross dressing | transvestism | cross | dressing | structure | sauce | abettor | cyclone
string bass | contrabass | string | bass | twine | pitch | repository | microscopy
false witness | perjurer | false | witness | informant | tubeless | desolation | stele
paving machine | pavior | paving | machine | pavement | device | police | punks
cosmetic surgery | facelift | cosmetic | surgery | toiletry | basidiocarp | taper | chattering
home run | homer | home | run | place | tally | ultracentrifugation | repartee
ill service | disservice | ill | service | ailment | work | slate | counterstain
north wind | northerly | north | wind | weather | waffle | steward | busyness
causal factor | determinant | causal | factor | cause | parallelopiped | hyperthyroidism | swayer
oral presentation | speechmaking | oral | presentation | viva | ceremony | heedfulness | prexy
urban center | city | urban | center | centre | binge | supplanting | bramble
wrist band | wristlet | wrist | band | carpus | set | palimony | conqueror
spin doctor | spinmeister | spin | doctor | rotation | doc | chrysolite | diagnostician
tearing down | demolishing | tearing | down | lacrimation | feather | lymphopoiesis | palsy
quotation mark | quote | quotation | mark | citation | grade | waviness | obsidian
minister plenipotentiary | envoy | minister | plenipotentiary | curate | diplomat | psychometrika | molality
black magic | sorcery | black | magic | blackness | thaumaturgy | recursion | disloyalty
acorn cup | cupule | acorn | cup | fruit | crockery | topi | infrequency
pubic bone | pubis | pubic | bone | os | mousetrap | hindrance | lymphokine
watering place | spa | watering | place | lacrimation | spot | wicker | motorman
composition board | cardboard | composition | board | composing | committee | ambassador | xenotransplantation
food color | coloring | food | color | nutrient | colour | rosewood | vendetta
armed services | military | armed | services | employment | homoeopath | anchovy | village
sulphuric acid | vitriol | sulphuric | acid | sulfuric | compound | belling | natator
whole note | semibreve | whole | note | concept | humpback | limeade | camas
rewrite man | redact | rewrite | man | revision | male | insulation | stereoscopy
cheese tray | cheeseboard | cheese | tray | food | receptacle | alkalemia | leap
frequency band | waveband | frequency | band | frequence | set | authorisation | milliped
stage technician | stagehand | stage | technician | phase | osculation | incisor | moviemaking
spectroscopic analysis | spectroscopy | spectroscopic | analysis | spectroscopical | investigation | boardinghouse | lesson
cattle pen | corral | cattle | pen | cows | overdraft | dimple | pillaging
brain disorder | encephalopathy | brain | disorder | encephalon | upset | synechia | forestage
plant toxin | phytotoxin | plant | toxin | works | poison | basophilia | addition
passenger vehicle | bus | passenger | vehicle | rider | conveyance | pachuco | phosphor
telegraph operator | telegrapher | telegraph | operator | telegraphy | function | smoother | whole
statute law | legislation | statute | law | act | jurisprudence | jinnee | magnolia
wild bergamot | monarda | wild | bergamot | state | orange | delta | polyvalence
white lead | ceruse | white | lead | person | advantage | retaliation | pie
black art | sorcery | black | art | blackness | creation | elegance | bevatron
breaking off | abruption | breaking | off | breakage | nature | introspection | dragonet
dining companion | tablemate | dining | companion | eating | comrade | paratroops | flatness
fish duck | merganser | fish | duck | consistory | connector | changeableness | loggerhead
rattlesnake plantain | helleborine | rattlesnake | plantain | rattler | herb | senna | teen
photoelectric cell | photocell | photoelectric | cell | photoelectrical | compartment | void | abduction
abstract art | abstractionism | abstract | art | abstraction | creation | cheekbone | potence
fast one | trick | fast | one | fasting | ace | topknot | grad
upper limit | maximum | upper | limit | berth | bound | galleon | conchology
garlic sauce | aioli | garlic | sauce | condiment | odor | stinging | radiotelephone
stomach ache | bellyache | stomach | ache | tummy | aching | myelin | bodywork
food shop | deli | food | shop | nutrient | store | laparoscopy | housebuilder
speech production | speaking | speech | production | address | act | curb | squelch
dangerous undertaking | adventure | dangerous | undertaking | unsafe | project | motmot | profanation
male chauvinist | sexist | male | chauvinist | animal | bigot | modern | fleck
birth rate | fertility | birth | rate | beginning | vivisection | usurer | harmoniser
top executive | magnate | top | executive | region | administrator | trek | fell
sand lance | launce | sand | lance | soil | spear | eclair | addend
good fortune | luckiness | good | fortune | advantage | luck | certitude | paraesthesia
lower limit | minimum | lower | limit | berth | bound | dirge | unfastening
sick person | sufferer | sick | person | people | individual | simian | elevated
zoonotic disease | zoonosis | zoonotic | disease | illness | ammobium | novelette | disciple
curved shape | curve | curved | shape | curving | form | class | kerygma
comic opera | bouffe | comic | opera | comedian | interaction | bryony | witch
fibre optics | fiberoptics | fibre | optics | fiber | physics | begonia | sweetness
social drinker | tippler | social | drinker | sociable | consumer | slippage | piperazine
sweet talker | smoothie | sweet | talker | phonetician | speaker | wheeze | toothpick
golden syrup | treacle | golden | syrup | aureate | sirup | guard | compliancy
psychedelic drug | hallucinogen | psychedelic | drug | agent | midrib | masterpiece | spending
promotional material | promotion | promotional | material | stuff | intruder | ragtag | troopship
chin music | prate | chin | music | mentum | envoy | bilirubin | copse
wireless telephone | radiotelephone | wireless | telephone | radio | phone | paederasty | sinner
dance palace | ballroom | dance | palace | art | castle | cottonwood | month
nuclear warhead | nuke | nuclear | warhead | atomic | payload | cryptomonad | damper
simple eye | ocellus | simple | eye | herb | oculus | weka | soiling
cooking utensil | cookware | cooking | utensil | cookery | implement | nation | transplantation
marriage broker | matchmaker | marriage | broker | matrimony | agent | washtub | sidewalk
grad student | postgraduate | grad | student | grade | pupil | undercoat | camion
idol worshiper | idolater | idol | worshiper | god | worshipper | horsewoman | pipework
combat boot | buskin | combat | boot | battle | footwear | dissimulation | photogravure
strange quark | squark | strange | quark | unusual | pontifical | vireo | aquamarine
decubitus ulcer | bedsore | decubitus | ulcer | position | ulceration | boss | efflux
feudal lord | seigneur | feudal | lord | feudalistic | jerk | vaporiser | ligan
spelling contest | spelldown | spelling | contest | orthography | competition | hydride | notability
physical exertion | exercise | physical | exertion | effort | curry | hellhound | marking
high tide | highwater | high | tide | degree | quest | responsibility | marlingspike
wrecking bar | crowbar | wrecking | bar | razing | barroom | aldehyde | evasion
drawing lots | sortition | drawing | lots | artwork | tons | liabilities | engram
dishwashing machine | dishwasher | dishwashing | machine | washup | device | garbology | toolhouse
draining board | drainboard | draining | board | exhausting | committee | enthronement | homegirl
hot cake | pancake | hot | cake | bar | disbandment | baud | setscrew
silent picture | silents | silent | picture | soundless | image | paratyphoid | chondrite
habitual criminal | recidivist | habitual | criminal | accustomed | felon | schoolhouse | ontology
car manufacturer | carmaker | car | manufacturer | auto | maker | spoonful | bedsore
field general | quarterback | field | general | tract | wonton | hypertonia | flood
mandibular bone | mandible | mandibular | bone | os | lesion | gloat | grocer
two iron | midiron | two | iron | deuce | sophism | jack | hypocalcemia
coffee shop | cafe | coffee | shop | java | store | dynamics | nephrolithiasis
blue blood | aristocrat | blue | blood | blueness | auklet | glycosuria | good
private parts | genitalia | private | parts | environment | ctenophore | waw | filariasis
field glasses | binoculars | field | glasses | tract | spectacles | headline | battlefront
silent person | dummy | silent | person | soundless | individual | grenade | defensive
drawing card | attractor | drawing | card | artwork | paper | myelinization | marigold
commercial traveller | roadman | commercial | traveller | ad | traveler | swathe | defibrillation
seed vessel | pericarp | seed | vessel | fruit | vas | outpouring | concern
exotic dancer | striptease | exotic | dancer | alien | terpsichorean | extinguishing | stench
meat house | smokehouse | meat | house | food | dwelling | ochre | propyl
red salmon | sockeye | red | salmon | redness | salmonid | firewood | horsemanship
brandy glass | snifter | brandy | glass | liquor | solid | decoding | alphanumerics
perceptual experience | percept | perceptual | experience | education | syndicalism | incumbrance | dredge
aggregate fruit | syncarp | aggregate | fruit | sum | widget | heirloom | freebee
absorption coefficient | absorptance | absorption | coefficient | sorption | constant | rigging | sorrow
landed gentry | squirearchy | landed | gentry | aristocracy | eluding | plasterboard | kindheartedness
past perfect | pluperfect | past | perfect | yesteryear | perfective | workingman | foresight
temperature reduction | cooling | temperature | reduction | decrease | alizarine | pigeonholing | spinney
foot lever | treadle | foot | lever | pes | bar | neutrophil | stance
idle talk | prate | idle | talk | operation | talking | tribune | ropeway
objective case | accusative | objective | case | aim | instance | hamper | bean
fringe benefit | perquisite | fringe | benefit | periphery | payment | hatful | ranter
second childhood | dotage | second | childhood | sec | superorder | dalesman | copestone
adult female | woman | adult | female | grownup | animal | signalman | scorbutus
dairy farmer | dairyman | dairy | farmer | farm | husbandman | eradicator | impresario
gravitational attraction | gravity | gravitational | attraction | gravitative | force | suntan | orifice
leaf beetle | chrysomelid | leaf | beetle | leafage | insect | strainer | instructress
rock lobster | langouste | rock | lobster | stone | shellfish | obeah | mistake
chin wag | chitchat | chin | wag | mentum | wit | appeaser | law
red cent | damn | red | cent | redness | legality | misanthropy | simian
stone plant | lithops | stone | plant | rock | works | autoradiography | inanity
cow pen | corral | cow | pen | cattle | flatwork | cream | favour
snake doctor | dragonfly | snake | doctor | serpent | doc | spinster | argument
public toilet | restroom | public | toilet | populace | lavatory | sporran | battleground
hummingbird moth | hawkmoth | hummingbird | moth | covey | slapper | cud | hunchback
sodium carbonate | soda | sodium | carbonate | salt | pinkie | defenestration | dogbane
even chance | tossup | even | chance | evening | opportunity | wolfhound | suppository
wise guy | wiseacre | wise | guy | manner | cat | murmur | pemphigus
film writer | screenwriter | film | writer | movie | author | ink | bindery
swelled head | egotism | swelled | head | big | caput | masterwort | sociobiology
fox hunting | foxhunt | fox | hunting | canine | hunt | incrustation | col
scientific discipline | science | scientific | discipline | subject | juggernaut | open | assemblage
corneal transplant | keratoplasty | corneal | transplant | graft | swop | balm | fluorochrome
private road | driveway | private | road | route | pycnogonid | edification | reign
abominable snowman | yeti | abominable | snowman | detestable | figure | qualm | onionskin
pendant earring | eardrop | pendant | earring | pendent | jewelry | dumbwaiter | gametophyte
tie tack | tiepin | tie | tack | necktie | bearing | supplicant | eggs
wading bird | wader | wading | bird | walk | vertebrate | part | basidium
evening clothes | formalwear | evening | clothes | eve | apparel | imagination | governed
instruction manual | instructions | instruction | manual | direction | handbook | sabra | airlock
end product | output | end | product | terminal | merchandise | grifter | tee
business leader | magnate | business | leader | concern | person | rand | jack
disk jockey | dj | disk | jockey | disc | horseman | chrysalis | dimity
merchant ship | freighter | merchant | ship | merchandiser | vessel | blastomere | harmonization
fortune telling | soothsaying | fortune | telling | luck | relation | toothpick | deism
guitar player | guitarist | guitar | player | participant | gesticulation | contemporaneity | carnelian
furniture maker | cabinetmaker | furniture | maker | furnishing | shaper | wiggler | asynchrony
plastic explosive | plastique | plastic | explosive | solid | chemical | pronunciation | therapeutics
money changer | exchanger | money | changer | modifier | starting | porc | pollster
visual aspect | appearance | visual | aspect | ocular | facet | betatron | purgation
white sauce | bechamel | white | sauce | person | condiment | clerk | ethylene
pleasure trip | excursion | pleasure | trip | pleasance | journey | haymow | dietician
water pill | diuretic | water | pill | liquid | thing | child | porc
tank suit | maillot | tank | suit | garment | excitement | isomerization | benefactor
economic science | economics | economic | science | economical | discipline | oiler | palliative
water clock | clepsydra | water | clock | liquid | timepiece | interdiction | airgun
hind end | buttocks | hind | end | grouper | terminal | costumier | pulpit
laying waste | ruining | laying | waste | parturition | material | boozer | cobbler
tying up | docking | tying | up | ligature | soddy | ounce | overpopulation
rapid climb | zoom | rapid | climb | waterway | ascent | novena | replica
white cinnamon | canella | white | cinnamon | person | bark | pneumothorax | tiff
seventh heaven | bliss | seventh | heaven | rank | paradise | doggerel | fiat
outer boundary | periphery | outer | boundary | bound | senator | fen | grudge
cow man | cattleman | cow | man | cattle | male | lipectomy | cameraman
natural event | happening | natural | event | achiever | methyltestosterone | beige | terrorisation
testicular cancer | seminoma | testicular | cancer | sett | prurience | poster | peristome
bargain rate | cheapness | bargain | rate | deal | conformism | rarefaction | tire
card shark | cardsharp | card | shark | paper | elasmobranch | tibia | casebook
reading desk | lectern | reading | desk | table | claustrophobe | slattern | bardolatry
dead soul | deceased | dead | soul | people | psyche | entrapment | endometritis
economic system | economy | economic | system | economical | instrumentality | coleus | broach
determining factor | determinant | determining | factor | deciding | cause | energizer | capsule
pontoon plane | floatplane | pontoon | plane | barge | airplane | cholecystokinin | depositary
financial officer | treasurer | financial | officer | fiscal | serviceman | shmuck | humus
jerking off | wank | jerking | off | jerk | impotency | gynecology | numerator
lower rank | inferiority | lower | rank | berth | line | assembling | rearmament
red heat | fieriness | red | heat | redness | energy | ambitiousness | carving
milk sugar | lactose | milk | sugar | beverage | sweetening | cupper | acetabulum
lawn bowling | bowls | lawn | bowling | field | game | duo | senescence
cat suit | leotard | cat | suit | feline | garment | sword | overpass
bad weather | inclemency | bad | weather | badness | conditions | morceau | tact
sea scorpion | scorpionfish | sea | scorpion | person | industrialization | synthesizer | chairperson
traditional knowledge | lore | traditional | knowledge | cognition | hearsay | immanence | marlinespike
adobe house | soddy | adobe | house | clay | dwelling | minaret | streptobacillus
kissing disease | mononucleosis | kissing | disease | caressing | illness | wick | greenbelt
graphic artist | printmaker | graphic | artist | picture | creator | pyrrhic | meaning
darkling beetle | tenebrionid | darkling | beetle | insect | diverticulitis | export | birdbath
software engineer | programmer | software | engineer | package | technologist | punting | quadruped
peat moss | sphagnum | peat | moss | humate | bryophyte | galvanization | vesuvian
brain doctor | neurologist | brain | doctor | encephalon | doc | phrasing | ballerina
inverse sine | arcsine | inverse | sine | opposite | sin | rectification | saxist
nose cone | ogive | nose | cone | chemoreceptor | artifact | switchboard | disfigurement
heart surgeon | cardiologist | heart | surgeon | bosom | sawbones | caracara | bowknot
breathing place | breather | breathing | place | respiration | spot | mastaba | momentousness
farming area | farmland | farming | area | agriculture | country | melaena | lymphography
coat rack | hatrack | coat | rack | overgarment | framework | publicist | historicism
fashion plate | dandy | fashion | plate | manner | home | countersuit | niacin
main road | highway | main | road | briny | route | bandbox | homoeopathy
cattle plague | rinderpest | cattle | plague | cows | pestilence | torticollis | teeter
textual matter | text | textual | matter | affair | muscovite | mile | rotenone
bush league | minors | bush | league | shrub | conference | cordon | dudgeon
lion monkey | tamarin | lion | monkey | primate | foreleg | farmer | pinner
red region | hellfire | red | region | redness | part | sender | catering
liver sausage | liverwurst | liver | sausage | meat | casuistry | spook | quadroon
mail pouch | mailbag | mail | pouch | message | bag | registrar | approximation
dinner jacket | tux | dinner | jacket | meal | coat | garden | projector
name calling | names | name | calling | career | highlight | stabilisation | fluctuation
smoky quartz | cairngorm | smoky | quartz | crystal | tapeworm | loser | advection
range pole | flagpole | range | pole | scope | rod | haptoglobin | coccidiosis
manufacturing business | manufacturer | manufacturing | business | fabrication | concern | glibness | ribier
fourth stomach | abomasum | fourth | stomach | rank | tummy | guvnor | mycoplasma
laurel wreath | medal | laurel | wreath | garland | hotelkeeper | so | wager
side dish | entremets | side | dish | region | crockery | exceedance | osteolysis
anal intercourse | sodomy | anal | intercourse | intercommunication | synchro | mobilization | bishop
secret code | cryptograph | secret | code | information | codification | solenoid | deviltry
electronic mail | email | electronic | mail | message | abasement | bigamy | conjugate
adoptive parent | adopter | adoptive | parent | genitor | potherb | tracery | abstainer
flowering plant | angiosperm | flowering | plant | blossoming | works | playacting | milliradian
pig farm | piggery | pig | farm | hog | workplace | estimation | savanna
hard rubber | vulcanite | hard | rubber | difficult | caoutchouc | attack | haystack
noncommissioned officer | noncom | noncommissioned | officer | serviceman | pentameter | antimycin | conquest
chemical science | chemistry | chemical | science | material | discipline | lighter | leishmaniosis
war machine | military | war | machine | warfare | device | ministrant | spermaceti
watering hole | spa | watering | hole | lacrimation | opening | boudoir | sharper
arc tangent | arctan | arc | tangent | discharge | communicant | hydroid | metro
reclining chair | recliner | reclining | chair | motion | seat | paintball | soutane
cadmium sulphide | greenockite | cadmium | sulphide | sulfide | scoff | parterre | rateables
sense impression | sensation | sense | impression | awareness | feeling | cameo | confectionery
stock raiser | stockman | stock | raiser | capital | centerline | mechanist | stretchiness
wood coal | lignite | wood | coal | titter | antique | lip | psilomelane
minor expense | incidental | minor | expense | child | disbursal | salon | eyelid
slide fastener | zipper | slide | fastener | person | chirology | calculus | numeracy
face cloth | washcloth | face | cloth | fabric | laddie | signifier | truncation
water company | waterworks | water | company | liquid | institution | metre | hypotenuse
church property | spiritualty | church | property | religion | belongings | phalanger | peeling
pagan religion | paganism | pagan | religion | heathen | faith | bowls | station
bur marigold | sticktight | bur | marigold | burr | flower | tipsiness | cornflour
fungus gnat | sciara | fungus | gnat | organism | preview | directivity | scratchpad
landscape architect | landscaper | landscape | architect | scenery | designer | nescience | attendee
sleeping accommodation | bedroom | sleeping | accommodation | sleep | adjustment | tabard | heronry
chorus girl | showgirl | chorus | girl | sound | miss | decency | being
ocean trip | voyage | ocean | trip | journey | forum | blackwood | keyboard
cobalt blue | aqua | cobalt | blue | blueness | railing | impotence | rake
mercantile system | mercantilism | mercantile | system | instrumentality | ratifier | nugget | bitok
animal nature | animality | animal | nature | beast | quality | kauri | sierra
water pipe | hookah | water | pipe | liquid | tube | heft | mattock
prayer beads | rosary | prayer | beads | supplication | string | hyperopia | managership
water faucet | hydrant | water | faucet | liquid | spigot | misgovernment | antimycin
natural state | wild | natural | state | achiever | province | hairstyle | hankie
street arab | gamin | street | arab | thoroughfare | cobbler | grate | myometrium
trash bin | ashcan | trash | bin | rubbish | container | scrapple | sandwichman
inverted comma | quote | inverted | comma | punctuation | nude | vitrine | octavo
ring road | beltway | ring | road | sound | route | vesicle | waterer
sea mat | bryozoan | sea | mat | oxidoreductase | chrysanthemum | dominant | alcove
runic letter | rune | runic | letter | missive | sura | boycott | kibe
sad sack | bungler | sad | sack | poke | antipope | harmonization | dammar
peace officer | lawman | peace | officer | order | serviceman | directness | penalty
diary keeper | diarist | diary | keeper | journal | defender | emergency | lockmaster
bass horn | sousaphone | bass | horn | pitch | noisemaker | unexpectedness | mealie
financial obligation | indebtedness | financial | obligation | fiscal | duty | shrinking | disparagement
temporal muscle | temporalis | temporal | muscle | musculus | propagation | paladin | vellum
mountain climbing | mountaineering | mountain | climbing | mount | climb | flyer | road
knee pants | breeches | knee | pants | genu | bloomers | wildebeest | maharajah
pruning hook | lopper | pruning | hook | cutting | catch | bosc | chordate
watch pocket | fob | watch | pocket | ticker | pouch | monal | psylla
oyster plant | salsify | oyster | plant | bivalve | works | mottle | partsong
calyx tube | hypanthium | calyx | tube | coil | tubing | auteur | kimberlite
sexual practice | sex | sexual | practice | pattern | lynchpin | heth | dementia
preconceived opinion | preconception | preconceived | opinion | sentiment | rigatoni | moistening | viewfinder
faux pas | gaffe | faux | pas | fake | step | gravida | acme
eye doctor | ophthalmologist | eye | doctor | oculus | doc | neurobiologist | gueridon
rubber stamp | handstamp | rubber | stamp | caoutchouc | cast | kith | barong
colloidal solution | sol | colloidal | solution | mixture | adapter | harmonizer | hymie
basketball player | basketeer | basketball | player | hoops | participant | transshipment | fibromyositis
ten percent | tenth | ten | percent | tenner | percentage | belligerency | experience
syllabic script | syllabary | syllabic | script | book | dogie | summer | attosecond
capitalist economy | capitalism | capitalist | economy | conservative | system | prehistory | annual
west wind | wester | west | wind | region | weather | homonym | thurifer
back country | backwoods | back | country | dorsum | state | sorehead | hoyden
capillary action | capillarity | capillary | action | tube | act | pothos | cinematographer
sex act | copulation | sex | act | enactment | pedlar | chromaticity | hamelia
word square | acrostic | word | square | foursquare | aerosol | glycine | vector
basic principle | fundamentals | basic | principle | rule | waltzer | foul | anchylosis
tilled land | plowland | tilled | land | disco | characterization | thalidomide | summary
cellular phone | cellphone | cellular | phone | telephone | rattail | sudation | grappa
dry run | rehearsal | dry | run | prohibitionist | tally | bad | sedative
hospital care | hospitalisation | hospital | care | infirmary | attention | bond | sledge
female parent | mother | female | parent | animal | genitor | ammonia | carpal
rum cocktail | daiquiri | rum | cocktail | liquor | damoiselle | anesthesia | rake
defensive measure | defense | defensive | measure | attitude | step | pate | lingerie
tympanic membrane | eardrum | tympanic | membrane | sheet | eclipsis | drum | kerosine
dump truck | dumper | dump | truck | shit | reprieve | racoon | rondelet
word division | hyphenation | word | division | acidification | tefillin | palpitation | mesothelium
metallurgical engineer | metallurgist | metallurgical | engineer | metallurgic | technologist | pastness | cotyledon
sea spider | pycnogonid | sea | spider | arachnid | overlord | uncovering | serial
nose count | census | nose | count | chemoreceptor | number | slouch | lefty
sealing wax | seal | sealing | wax | waterproofing | lipid | orthogonality | perigon
coral tree | erythrina | coral | tree | pink | kerosine | detriment | humming
sailing boat | sailboat | sailing | boat | seafaring | vessel | epiphyllum | imide
physical geography | physiography | physical | geography | geographics | paperback | bobber | assailant
poisonous substance | poison | poisonous | substance | toxicant | matter | campong | pleurisy
nonfictional prose | nonfiction | nonfictional | prose | kindling | hypopigmentation | conversance | austral
semiconducting material | semiconductor | semiconducting | material | semiconductive | stuff | cassowary | pardon
civil wrong | tort | civil | wrong | wrongfulness | blanket | stela | soundlessness
administrative official | bureaucrat | administrative | official | functionary | jennet | screw | youngster
moon ray | moonbeam | moon | ray | satellite | beam | sheepman | sailor
amniotic sac | amnion | amniotic | sac | amnionic | pouch | neoplasia | sidestep
gentle wind | breeze | gentle | wind | soft | weather | hepatitis | sixteenth
card game | cards | card | game | paper | activity | financier | washables
gymnastic apparatus | exerciser | gymnastic | apparatus | acrobatic | setup | droning | representation
blood relative | cognate | blood | relative | relation | gull | epilator | like
intestinal flu | gastroenteritis | intestinal | flu | enteric | influenza | learner | ankyloglossia
biological defence | biodefense | biological | defence | biologic | defense | hyperthyroidism | epiglottitis
sentence structure | syntax | sentence | structure | construction | anemometer | scooter | ephemera
olfactory perception | smell | olfactory | perception | olfactive | percept | anhedonia | heirloom
traveling salesman | roadman | traveling | salesman | travel | salesperson | sempstress | wave
rock drill | borer | rock | drill | stone | tool | eparchy | countenance
river blindness | onchocerciasis | river | blindness | stream | sightlessness | polygene | protohistory
lumbar pain | lumbago | lumbar | pain | hurting | unhealthiness | poultryman | squiggle
live load | superload | live | load | unrecorded | loading | erecting | telecommunication
hatchet job | defamation | hatchet | job | tomahawk | occupation | gammon | inhumanity
marine museum | aquarium | marine | museum | leatherneck | depository | depolarisation | inwardness
farm worker | farmhand | farm | worker | workplace | person | dint | motive
synovial membrane | synovium | synovial | membrane | sheet | cytogeneticist | paleoclimatology | gutsiness
blood kinship | consanguinity | blood | kinship | affinity | wildfowl | ember | forewarning
garbage can | ashcan | garbage | can | refuse | tin | oilcloth | cheeseburger
blood feud | vendetta | blood | feud | conflict | sociality | breaker | barytes
propylene glycol | propanediol | propylene | glycol | propene | ethanediol | faithful | stereoscopy
prompt copy | promptbook | prompt | copy | prompting | transcript | reassembly | theodolite
mouse deer | chevrotain | mouse | deer | rodent | cervid | curbstone | curler
poll taker | pollster | poll | taker | canvass | customer | lumen | emaciation
mercurous chloride | calomel | mercurous | chloride | mercuric | compound | defiance | muskellunge
cow barn | cowshed | cow | barn | cattle | matting | candor | splicing
coal oil | kerosene | coal | oil | lipid | cogency | unacceptability | anticoagulant
blood relation | cognate | blood | relation | abstraction | passing | stockroom | torturer
push back | rollback | push | back | pushing | dorsum | escherichia | principality
air passage | airway | air | passage | gas | transition | apophasis | sleight
butterfly flower | schizanthus | butterfly | flower | angiosperm | cup | tabulation | plastid
line drive | liner | line | drive | formation | thrust | backspin | milliammeter
loan translation | calque | loan | translation | debt | rendering | planter | voyager
suction lipectomy | liposuction | suction | lipectomy | pressure | whirligig | fermentation | blockbuster
freak out | disorientation | freak | out | monster | failure | nates | secretiveness
breathing time | breather | breathing | time | respiration | clip | noncitizen | subsidiary
eager beaver | sharpie | eager | beaver | bore | fur | puce | psycho
cutting out | ablation | cutting | out | edged | failure | tapeworm | appetiser
bomb shelter | bombproof | bomb | shelter | weaponry | structure | wonton | segmentation
intestinal obstruction | ileus | intestinal | obstruction | enteric | obstructor | stepfather | tournament
psychological science | psychology | psychological | science | discipline | nakedness | bigness | craftsman
bass viol | gamba | bass | viol | pitch | lobby | implausibility | tack
animal scientist | zoologist | animal | scientist | beast | person | serow | haulier
research worker | researcher | research | worker | investigation | person | divan | receding
political relation | politics | political | relation | abstraction | lounge | imperialist | arccos
dental medicine | dentistry | dental | medicine | alveolar | inclination | shimmer | pluck
polygonal shape | polygon | polygonal | shape | form | gig | anastomosis | pedlar
gravitational force | gravity | gravitational | force | gravitative | influence | bleachers | wheal
television tube | kinescope | television | tube | telecasting | tubing | sweating | rev
top boot | buskin | top | boot | region | footwear | everting | desperado
organic law | constitution | organic | law | fertilizer | jurisprudence | gel | asterion
diabetic acidosis | ketoacidosis | diabetic | acidosis | pathology | maladjustment | ornamentation | despoilation
night blindness | nyctalopia | night | blindness | nighttime | sightlessness | mosque | metrics
lip service | hypocrisy | lip | service | articulator | work | schooldays | eucalypt
round shot | cannonball | round | shot | ammunition | shooting | gangsta | conjuring
boundary line | border | boundary | line | bound | formation | bowl | ripcord
health problem | unhealthiness | health | problem | wellness | job | nervure | scyphus
contraceptive method | contraception | contraceptive | method | preventive | mender | smog | heterozygote
head covering | veil | head | covering | caput | cover | talent | dowser
retirement benefit | superannuation | retirement | benefit | status | payment | deb | kowtow
human paleontology | paleoanthropology | human | paleontology | homo | palaeontology | calligraphy | rainbow
good humor | amiability | good | humor | advantage | wit | erroneousness | eyepatch
taxonomic group | taxon | taxonomic | group | taxonomical | grouping | pseudobulb | mudskipper
chance event | fortuity | chance | event | opportunity | orchil | pinole | penchant
fundamental law | constitution | fundamental | law | factor | jurisprudence | macrocytosis | edibility
ozone layer | ozonosphere | ozone | layer | gas | bed | perfectibility | sleet
ice axe | piolet | ice | axe | crystal | ax | photochemistry | millrun
cellulose nitrate | nitrocellulose | cellulose | nitrate | polysaccharide | compound | harlotry | scrimmage
dental practitioner | dentist | dental | practitioner | alveolar | practician | lido | sash
green algae | chlorophyte | green | algae | greenness | alga | matador | calming
metallic element | metal | metallic | element | fabric | component | arcsecond | autacoid
side arm | pistol | side | arm | region | limb | abfarad | easement
cultivated land | plowland | cultivated | land | pew | syntax | roadhog | clergy
black sheep | scapegrace | black | sheep | blackness | bovid | relinquishing | wold
boulder clay | till | boulder | clay | bowlder | soil | euthanasia | pacing
horizontal stabilizer | tailplane | horizontal | stabilizer | orientation | chemical | italic | profaneness
rear lamp | taillight | rear | lamp | formation | lithophyte | tattler | aster
horseback rider | horseman | horseback | rider | traveler | carting | bole | ninetieth
sensing element | detector | sensing | element | detection | component | masterwort | prosody
parachute jumper | parachutist | parachute | jumper | chute | person | nauch | lugworm
middle class | bourgeoisie | middle | class | center | category | inheritor | tablespoon
body type | somatotype | body | type | kind | explanans | supersymmetry | inoculating
black lead | graphite | black | lead | blackness | advantage | pillager | sclerotinia
plane tree | platan | plane | tree | airplane | unicorn | diagonal | vacation
bird watcher | ornithologist | bird | watcher | vertebrate | spectator | glissando | pressman
written text | transcription | written | text | matter | hedgehog | subtotal | incurring
weather stripping | weatherstrip | weather | stripping | conditions | denudation | provender | carton
big businessman | magnate | big | businessman | large | businessperson | furniture | halberd
touch perception | tactility | touch | perception | touching | percept | quercitron | vouchee
soot black | ebony | soot | black | lampblack | blackness | groundball | striatum
surface soil | topsoil | surface | soil | artifact | dirt | footballer | ecosystem
time being | nonce | time | being | clip | beingness | dealignment | stack
firing mechanism | gunlock | firing | mechanism | fire | discursiveness | excreting | mantua
stamp collecting | philately | stamp | collecting | cast | collection | hoarding | cask
pediatric medicine | pediatrics | pediatric | medicine | paediatric | boxer | khalifah | druggist
record player | phonograph | record | player | evidence | participant | inhalator | plyers
giant squid | architeuthis | giant | squid | animal | calamari | fingerpost | smooth
fruit sugar | fructose | fruit | sugar | sweetening | brittleness | pickerel | deuterium
military blockade | siege | military | blockade | force | encirclement | diminutive | pubes
hard coal | anthracite | hard | coal | difficult | kiloliter | chemosynthesis | pelmet
swamp fever | leptospirosis | swamp | fever | swampland | pyrexia | cirrocumulus | plump
sweet talk | blarney | sweet | talk | phonetician | talking | warehouser | sordino
flow diagram | flowchart | flow | diagram | flowing | drawing | hypsography | nut
gall wasp | gallfly | gall | wasp | galvanism | vendee | potpie | beany
free thought | deism | free | thought | people | idea | queerness | midafternoon
computer science | computing | computer | science | machine | discipline | fuzz | slugger
marsh elder | iva | marsh | elder | marshland | senior | wildebeest | fascicle
loan shark | usurer | loan | shark | debt | elasmobranch | incorruption | pharmacogenetics
gas meter | gasometer | gas | meter | metre | shade | duality | tensor
swimming pool | natatorium | swimming | pool | swim | excavation | dowery | loader
ship builder | shipwright | ship | builder | vessel | material | codefendant | spectre
wine merchant | vintner | wine | merchant | vino | merchandiser | eland | heedlessness
concave shape | concavity | concave | shape | form | maenad | scatter | mimic
state highway | expressway | state | highway | province | road | halobacteria | photoemission
fundamental principle | fundamentals | fundamental | principle | factor | rule | hotplate | reconciler
enteric bacteria | enterobacteria | enteric | bacteria | enteral | bacterium | gyration | ridgepole
case shot | canister | case | shot | instance | shooting | conundrum | credo
wood rabbit | cottontail | wood | rabbit | coney | secularisation | plodder | swearword
pregnant chad | dimple | pregnant | chad | paper | strikebreaking | gonif | effeminacy
railway man | trainman | railway | man | railroad | male | prelims | rib
turning away | avoidance | turning | away | turn | bead | antibaryon | wafer
furnace lining | refractory | furnace | lining | chamber | liner | argentite | matting
station agent | stationmaster | station | agent | facility | petiole | immediateness | consortium
confidence game | bunco | confidence | game | assurance | activity | theologian | chorea
small town | village | small | town | little | municipality | shuteye | thyromegaly
flexible joint | hinge | flexible | joint | articulation | paperwork | wpm | tetany
drug traffic | narcotraffic | drug | traffic | agent | collection | chloasma | coagulator
public assistance | welfare | public | assistance | populace | aid | laurels | wincey
inverse cosine | arccosine | inverse | cosine | opposite | cos | requiescat | tint
upper jaw | maxilla | upper | jaw | berth | bone | velour | hyoscine
ill fame | notoriety | ill | fame | ailment | celebrity | punch | cane
sebaceous cyst | wen | sebaceous | cyst | greasy | pathology | othonna | aircrew
inner circle | clique | inner | circle | interior | ellipse | intrados | diuretic
work shoe | brogan | work | shoe | activity | footwear | coloration | bluegrass
lens maker | optician | lens | maker | lense | shaper | fisher | credentials
knuckle duster | knucks | knuckle | duster | sandstorm | indiscretion | skullcap | love
legislative assembly | legislature | legislative | assembly | machine | collagen | inebriate | retinene
embroidery hoop | tambour | embroidery | hoop | embellishment | skeleton | winking | attendance
visual purple | rhodopsin | visual | purple | ocular | livery | foreskin | whispering
lift bridge | drawbridge | lift | bridge | aid | span | austerity | knuckler
east wind | easterly | east | wind | eastward | weather | back | chaenactis
lead carbonate | ceruse | lead | carbonate | advantage | salt | courgette | penguin
sulfuric acid | vitriol | sulfuric | acid | sulphuric | compound | milepost | tarmac
religious belief | religion | religious | belief | spiritual | content | soiree | mastication
wood engraving | woodcut | wood | engraving | print | dormancy | preceptor | willies
body armour | cataphract | body | armour | armor | herringbone | rumrunner | biologist
postal card | postcard | postal | card | paper | sidesaddle | seam | matzoh
ethyl alcohol | ethanol | ethyl | alcohol | alkyl | intoxicant | ovipositor | official
voiced sound | sonant | voiced | sound | soft | bilges | swagger | paviour
carbon tetrachloride | tetrachloromethane | carbon | tetrachloride | compound | aristocrat | numeracy | treetop
jewelry maker | jeweler | jewelry | maker | jewellery | shaper | monogamy | halogen
flying bridge | flybridge | flying | bridge | flight | span | offing | barbarousness
stamp collector | philatelist | stamp | collector | cast | aggregator | rewording | syllabication
falling off | slump | falling | off | slattern | confiture | affixation | bilge
sampling station | sampler | sampling | station | choice | facility | agnate | bowstring
so long | adieu | so | long | sol | microphone | tortellini | troop
lazar house | lazaretto | lazar | house | leper | dwelling | gamesmanship | reconnaissance
prickly poppy | argemone | prickly | poppy | bristly | flower | rickettsialpox | battery
heavy weapon | artillery | heavy | weapon | actor | arm | phone | etagere
allergic reaction | allergy | allergic | reaction | cappelletti | vanquisher | nostalgia | whinny
legal philosophy | jurisprudence | legal | philosophy | doctrine | contracture | doyenne | fondler
short letter | billet | short | letter | tract | missive | abstractor | herd
stock list | inventory | stock | list | capital | listing | compounding | scenario
short temper | irascibility | short | temper | tract | pique | pronouncement | flunk
freedom fighter | insurgent | freedom | fighter | state | combatant | fewness | tenorist
road runner | marathoner | road | runner | route | smuggler | swot | recap
grayish brown | fawn | grayish | brown | grey | brownness | justiciar | sparkler
goose bump | gooseflesh | goose | bump | injury | grayness | homecoming | frisson
cleft lip | harelip | cleft | lip | indentation | articulator | wrongness | mitogen
spring chicken | youth | spring | chicken | springtime | poulet | indebtedness | homomorphism
legal expert | jurist | legal | expert | person | grapevine | rewording | takedown
tooth decay | caries | tooth | decay | bone | seismography | viewgraph | estimator
pine nut | pignolia | pine | nut | conifer | seed | profusion | majorette
street urchin | guttersnipe | street | urchin | thoroughfare | child | counselling | arts
sneak thief | pilferer | sneak | thief | furtive | stealer | autogyro | dairymaid
minor tranquilizer | anxiolytic | minor | tranquilizer | child | tranquillizer | neck | hamster
barbed wire | barbwire | barbed | wire | biting | ligament | crocodilian | indubitability
physiological reaction | reflex | physiological | reaction | bonce | landfall | eosinophilia | nosewheel
police car | cruiser | police | car | constabulary | auto | crusade | stroke
blue vitriol | chalcanthite | blue | vitriol | blueness | acid | joke | xenotransplant
refuse heap | scrapheap | refuse | heap | garbage | pile | hypercellularity | pacifier
abstract thought | reasoning | abstract | thought | abstraction | idea | flavin | denationalisation
flute player | flutist | flute | player | woodwind | participant | calisthenics | impurity
married man | husband | married | man | person | male | exchange | boatswain
widow bird | whydah | widow | bird | woman | vertebrate | bradawl | respite
chit chat | gab | chit | chat | girl | confab | busyness | shovel
battle royal | melee | battle | royal | conflict | sail | sunglass | grunter
passive resistance | nonviolence | passive | resistance | voice | opposition | pya | hilarity
medical examiner | coroner | medical | examiner | checkup | tester | yore | pneumoconiosis
existentialist philosophy | existentialism | existentialist | philosophy | philosopher | doctrine | external | acetonuria
brake system | brakes | brake | system | restraint | instrumentality | brainpower | money
unsecured bond | debenture | unsecured | bond | unbarred | attraction | mentality | blade
prehistoric culture | prehistory | prehistoric | culture | prehistorical | civilization | deeds | dallier
night watch | midwatch | night | watch | nighttime | ticker | deathtrap | tender
bed cover | bedspread | bed | cover | screen | poliomyelitis | camp | alpaca
foolish woman | flibbertigibbet | foolish | woman | female | obtainment | primrose | impounding
student residence | dormitory | student | residence | pupil | abode | gangplank | dad
river bottom | riverbed | river | bottom | stream | underside | epigon | helper
gag rule | cloture | gag | rule | joke | regulation | monster | dichotomy
insurance firm | insurer | insurance | firm | security | house | compunction | yuppie
outdoor stage | bandstand | outdoor | stage | outside | phase | disfiguration | yeller
pleasure seeker | hedonist | pleasure | seeker | pleasance | searcher | photocoagulation | beanie
magnetic levitation | maglev | magnetic | levitation | phenomenon | hawse | geometrician | orach
nylon stocking | nylons | nylon | stocking | polyamide | hosiery | omnipresence | plantigrade
second thought | afterthought | second | thought | sec | idea | andiron | agriculturalist
council member | councillor | council | member | associate | norm | tallyman | incompetent
patrol car | cruiser | patrol | car | detachment | auto | adaptor | thrusting
food colour | coloring | food | colour | nutrient | color | wading | nil
front matter | prelims | front | matter | forepart | affair | user | brain
moon blindness | nyctalopia | moon | blindness | satellite | sightlessness | guile | tubercular
snap ring | carabiner | snap | ring | catch | sound | clipboard | glutton
soya bean | soy | soya | bean | soybean | legume | interrelatedness | decree
electric power | wattage | electric | power | car | powerfulness | parasol | diapir
bronchial pneumonia | bronchopneumonia | bronchial | pneumonia | appendectomy | afterburner | venom | rift
cubic decimeter | liter | cubic | decimeter | decimetre | rattail | cocoanut | belling
alcohol addiction | alcoholism | alcohol | addiction | intoxicant | dependence | candor | conformist
window glass | pane | window | glass | framework | solid | gaggle | precept
student nurse | probationer | student | nurse | pupil | tyrosine | skep | chophouse
holy oil | chrism | holy | oil | sanctum | lipid | ejector | roommate
stool pigeon | fink | stool | pigeon | seat | regatta | informer | heading
sexual desire | concupiscence | sexual | desire | feeling | tipstaff | tonometer | grizzle
grazing land | pasture | grazing | land | graze | infanticide | plush | carillonneur
bathing machine | bathhouse | bathing | machine | diversion | device | prude | dielectric
common soldier | private | common | soldier | park | wiz | balanoposthitis | lutein
intimate apparel | lingerie | intimate | apparel | confidant | dress | fording | bolus
optical density | absorbance | optical | density | denseness | moneylender | celestite | expectedness
china stone | kaolin | china | stone | rock | piffle | unsightliness | deadeye
picture element | pixel | picture | element | image | component | finale | quoit
assumed name | alias | assumed | name | false | isomerization | livestock | resuscitator
pea tree | caragana | pea | tree | legume | trimer | blocker | sente
situation comedy | sitcom | situation | comedy | state | drama | fearlessness | spiritualization
magnetic force | magnetism | magnetic | force | influence | nostoc | homestretch | marshal
after part | stern | after | part | portion | techno | weeper | forensics
shepherd dog | sheepdog | shepherd | dog | clergyman | canine | covalence | dissemination
electronic image | bitmap | electronic | image | representation | freshet | doorjamb | foretop
drug company | pharma | drug | company | agent | institution | competitiveness | greisen
speed demon | speeder | speed | demon | velocity | devil | topmast | rock
light intensity | candlepower | light | intensity | strength | honorarium | insolvency | chorine
roundabout way | detour | roundabout | way | circle | manner | kleptomania | casket
male parent | father | male | parent | animal | genitor | tamoxifen | drawbridge
trash pile | scrapheap | trash | pile | rubbish | heap | aconite | dossier
card sharp | sharper | card | sharp | paper | smallness | eggar | reflector
class fellow | schoolmate | class | fellow | category | chap | equivalent | helping
dumb show | pantomime | dumb | show | dense | entertainment | savouring | fresher
shop assistant | salesclerk | shop | assistant | store | helper | alcalde | subpopulation
synovial fluid | synovia | synovial | fluid | substance | underlip | siesta | captainship
bed clothing | bedclothes | bed | clothing | vesture | antimetabolite | jongleur | chalcanthite
central body | centrosome | central | body | exchange | flugelhorn | alternator | imperishability
gay woman | lesbian | gay | woman | homosexual | female | horsewoman | tree
shoulder bone | scapula | shoulder | bone | os | iota | motionlessness | cryptomonad
universal solvent | alkahest | universal | solvent | rule | dissolvent | crozier | paperhanging
egg cell | ovum | egg | cell | compartment | pall | dipterocarp | kilderkin
good spirit | eudaemon | good | spirit | advantage | epos | graph | admonisher
black tie | tux | black | tie | blackness | necktie | largeness | advertiser
vital organ | vitals | vital | organ | critical | leeway | password | teepee
iron collar | garrote | iron | collar | neckband | amenity | piety | cowlick
badminton racket | battledore | badminton | racket | noise | theosophist | toque | basophil
garbage hauler | garbageman | garbage | hauler | refuse | haulier | bialystoker | shortgrass
heart specialist | cardiologist | heart | specialist | bosom | specializer | vascularity | trombonist
trash barrel | ashcan | trash | barrel | rubbish | tube | liturgist | carbine
legal residence | domicile | legal | residence | abode | cowshed | oppositeness | otter
film editing | cutting | film | editing | movie | redaction | headphone | destiny
arc sine | arcsin | arc | sine | discharge | sin | parthenogenesis | characin
alkyl halide | haloalkane | alkyl | halide | group | salt | browallia | sportsmanship
badminton racquet | battledore | badminton | racquet | racket | drumlin | world | spec
hard worker | striver | hard | worker | difficult | person | diffuser | philhellenism
linear accelerator | linac | linear | accelerator | additive | gas | codex | banksia
forward pass | aerial | forward | pass | walk | metarule | monomer | watcher
belly button | navel | belly | button | abdomen | fastener | shake | schlemiel
bee house | apiary | bee | house | dwelling | ounce | processing | roaring
news bulletin | newsflash | news | bulletin | intelligence | report | homogeny | misanthrope
parasitic worm | helminth | parasitic | worm | parasitical | invertebrate | brittleness | meteorite
genital organ | genitalia | genital | organ | venereal | acceptability | defilade | suddenness
motor neuron | motoneuron | motor | neuron | machine | midbrain | tenderization | kowtow
axial motion | roll | axial | motion | gesture | cathedral | piss | reveller
red worm | earthworm | red | worm | redness | invertebrate | conclusion | mumble
malicious gossip | scandal | malicious | gossip | chitchat | histone | abstractionism | pottery
raw throat | pharyngitis | raw | throat | altogether | pharynx | schooling | paperhanging
athletic wear | sportswear | athletic | wear | deterioration | polyploid | ocher | chert
goggle box | telly | goggle | box | container | roast | geometer | upsilon
refuse collector | garbageman | refuse | collector | garbage | aggregator | simony | arouser
blowing up | berating | blowing | up | processing | seism | spill | haem
higher status | seniority | higher | status | position | aid | clobber | affectedness
malt sugar | maltose | malt | sugar | malted | sweetening | jog | plot
fire station | firehouse | fire | station | happening | facility | spoilage | wyvern
nose job | rhinoplasty | nose | job | chemoreceptor | occupation | ridley | eternity
mountain man | frontiersman | mountain | man | mount | male | coastland | colonization
seed leaf | cotyledon | seed | leaf | fruit | leafage | mestranol | runner
monetary value | price | monetary | value | pecuniary | fiend | unawareness | summer
assassin bug | reduviid | assassin | bug | assassinator | insect | faultlessness | lattice
slide rule | slipstick | slide | rule | regulation | cyclicity | patching | rainwater
armed robbery | holdup | armed | robbery | larceny | proceeds | lockman | shirting
hair grease | hairdressing | hair | grease | oil | invulnerability | rinse | lithographer
medical student | medico | medical | student | checkup | pupil | affaire | effeminacy
portrait painter | portraitist | portrait | painter | portrayal | artist | ganglion | disaccharidase
dead reckoning | guesswork | dead | reckoning | people | calculation | vandalism | enrolment
crescent roll | croissant | crescent | roll | curve | rotation | paging | mumble
tool case | toolbox | tool | case | implement | instance | disambiguation | presumption
ear doctor | otologist | ear | doctor | doc | flare | collectivization | inferiority
terrorist act | terrorism | terrorist | act | radical | enactment | constancy | percent
mental disorder | folie | mental | disorder | upset | whitening | matrimony | barman
tibia vara | bowleg | tibia | vara | shinbone | cavy | exaltation | casein
unleavened bread | matzo | unleavened | bread | unraised | breadstuff | peahen | ruse
titanium oxide | titania | titanium | oxide | compound | tahini | mesenchyme | healing
launch area | launchpad | launch | area | motorboat | country | dishpan | compare
personal business | affairs | personal | business | concern | shuck | newsmonger | favus
china clay | kaolin | china | clay | soil | moray | ramekin | privacy
rest stop | layby | rest | stop | remainder | halt | exoticness | brachyuran
alcoholic beverage | alcohol | alcoholic | beverage | alky | drink | statice | cruse
trackless trolley | trolleybus | trackless | trolley | streetcar | raffle | harpist | apologetics
police matron | policewoman | police | matron | constabulary | wife | luck | painkiller
idle words | malarkey | idle | words | operation | speech | repression | diving
good day | adieu | good | day | advantage | labourer | stalwart | larboard
induction accelerator | betatron | induction | accelerator | initiation | gas | pyridine | sweep
large number | multitude | large | number | size | figure | appoggiatura | wintertime
council chamber | boardroom | council | chamber | enclosure | praetorship | cringle | freezing
prosthetic device | prosthesis | prosthetic | device | instrumentality | snob | lever | combining
crushed rock | gravel | crushed | rock | stone | siltstone | millionaire | hotbox
first name | forename | first | name | rank | djinni | cocoon | gunman
security guard | watchman | security | guard | safety | defender | subway | huitre
family tree | genealogy | family | tree | household | ichthyology | landscape | stupefaction
dock worker | stevedore | dock | worker | enclosure | person | tup | bethel
athletic type | mesomorphy | athletic | type | kind | copyholder | proficiency | dermatomyositis
gear lever | gearshift | gear | lever | cogwheel | bar | autoimmunity | inflow
uneducated person | ignoramus | uneducated | person | individual | coast | gelly | tabes
sea biscuit | hardtack | sea | biscuit | spire | assize | feline | bountifulness
mechanical man | android | mechanical | man | male | majors | metrication | dimmer
business district | downtown | business | district | concern | territory | mantilla | maidservant
wood sugar | xylose | wood | sugar | sweetening | flashgun | tread | patchiness
military personnel | soldiery | military | personnel | force | organization | pimp | scald
elbow grease | exertion | elbow | grease | cubitus | oil | nonattendance | desiccant
trust territory | trusteeship | trust | territory | property | district | egress | quantifiability
world traveler | globetrotter | world | traveler | universe | traveller | tabloid | parts
dramatic art | dramaturgy | dramatic | art | creation | festival | cittern | tiercel
free spirit | freewheeler | free | spirit | people | sesamoid | hagiographer | renewal
morning prayer | matins | morning | prayer | morn | supplication | stir | xylem
cattle farm | ranch | cattle | farm | cows | workplace | fossa | pinkness
race horse | bangtail | race | horse | contest | equine | busybody | crupper
public eye | limelight | public | eye | populace | oculus | decorativeness | pyemia
nettle rash | urticaria | nettle | rash | weed | roseola | digitigrade | signaling
wet blanket | spoilsport | wet | blanket | moisture | cover | inauguration | shipment
complex number | imaginary | complex | number | composite | figure | hypesthesia | schlep
stock farmer | stockman | stock | farmer | capital | husbandman | instigation | expertise
psychic phenomenon | parapsychology | psychic | phenomenon | occultist | process | wading | creativeness
standing stone | menhir | standing | stone | status | rock | lawmaking | abnegation
display window | shopwindow | display | window | show | framework | hemophilia | grubbiness
horse fly | cleg | horse | fly | equine | cashier | organdy | liquidator
water witch | dowser | water | witch | liquid | enchantress | reburying | franc
bus driver | busman | bus | driver | autobus | operator | sheesha | pyromorphite
philanthropic gift | philanthropy | philanthropic | gift | beneficent | acquisition | cognomen | spearhead
flying cat | colugo | flying | cat | flight | feline | keynote | quenching
reducing agent | reducer | reducing | agent | reduction | setback | container | indorsement
rear light | taillight | rear | light | formation | heuristic | nausea | enfeoffment
venous thrombosis | phlebothrombosis | venous | thrombosis | occlusion | bloodshed | applet | mitzvah
corneal graft | keratoplasty | corneal | graft | transplant | normalcy | transactor | abyss
mineral extraction | beneficiation | mineral | extraction | material | autograft | jockey | secondo
muscle builder | bodybuilder | muscle | builder | musculus | material | osteoblastoma | exportation
driving force | drive | driving | force | impulsive | influence | skywriting | diagnosis
cleaning lady | charwoman | cleaning | lady | cleansing | woman | aberrant | knock
organic structure | body | organic | structure | fertilizer | construction | squeal | lashing
applied scientist | engineer | applied | scientist | person | ephedra | quin | shark
whole number | integer | whole | number | concept | figure | sallet | crocodilian
biological defense | biodefense | biological | defense | biologic | defence | fasciolopsiasis | flash
scarlet fever | scarlatina | scarlet | fever | vermilion | pyrexia | entrepreneur | bend
cordial reception | hospitality | cordial | reception | liqueur | response | driver | wrist
toll collector | tollkeeper | toll | collector | fee | aggregator | mercer | exhibitioner
tap house | tavern | tap | house | pat | dwelling | harmoniser | schoolgirl
internal organ | viscus | internal | organ | morphophonemics | crib | viola | gaslight
infantile paralysis | poliomyelitis | infantile | paralysis | childish | palsy | gouge | ballet
trombone player | trombonist | trombone | player | brass | participant | bye | mirage
ciliated protozoan | ciliate | ciliated | protozoan | protozoon | huckaback | palate | fleet
house servant | domestic | house | servant | dwelling | retainer | thundershower | requiem
faculty member | academic | faculty | member | module | associate | yes | shelterbelt
sales rep | salesperson | sales | rep | income | congressman | descent | swatch
private instructor | tutor | private | instructor | teacher | scads | warplane | general
fighting cock | gamecock | fighting | cock | fight | prick | emission | gangrene
air duct | airway | air | duct | gas | canal | potoroo | radical
accident surgery | traumatology | accident | surgery | mishap | cementum | semolina | cuddling
half sister | stepsister | half | sister | sis | silk | jean | badminton
secret agent | operative | secret | agent | information | specializer | charitableness | lino
mock sun | parhelion | mock | sun | derision | star | slaughterer | conjunctivitis
retail merchant | retailer | retail | merchant | selling | merchandiser | lunation | olecranon
verse form | poem | verse | form | poetry | signifier | bloodsucker | rational
renal lithiasis | nephrolithiasis | renal | lithiasis | nephritic | pathology | stigmatisation | bookmaker
metal money | coinage | metal | money | metallic | gonorrhea | outpatient | inhalation
grappling hook | grapnel | grappling | hook | wrestle | catch | glaze | moralization
suburban area | suburb | suburban | area | country | waterleaf | clarification | kidnapping
married woman | wife | married | woman | person | female | traction | livestock
wireless telegraphy | radiotelegraph | wireless | telegraphy | radio | telecommunication | sartor | waddler
blue cheese | bleu | blue | cheese | blueness | food | stenography | meander
aluminum oxide | alumina | aluminum | oxide | aluminium | compound | signalization | magenta
wasting disease | phthisis | wasting | disease | cachexia | illness | envoy | ambitiousness
play group | playschool | play | group | drama | grouping | snuffbox | insomnia
compression bandage | tourniquet | compression | bandage | compaction | patch | onus | centrifugation
coal black | ebony | coal | black | blackness | approver | largess | pedology
welfare worker | caseworker | welfare | worker | aid | person | sentinel | multitude
whirling dervish | whirler | whirling | dervish | gyration | fakir | purposefulness | kurta
fellow worker | colleague | fellow | worker | chap | person | dicotyledon | simpleton
level best | utmost | level | best | degree | attempt | sustentation | sentimentalism
prison guard | jailer | prison | guard | defender | thermocouple | condensation | free
bathing suit | swimsuit | bathing | suit | diversion | garment | inverse | regression
taking hold | prehension | taking | hold | pickings | clasp | superload | thoracotomy
sun lounge | sunporch | sun | lounge | star | sofa | coagulum | irregularity
cubic centimeter | milliliter | cubic | centimeter | centimetre | supination | wardrobe | stretching
airplane propeller | airscrew | airplane | propeller | aeroplane | propellor | fecklessness | hartebeest
heavy spar | barite | heavy | spar | actor | mineral | beneficiation | capstan
noun phrase | nominal | noun | phrase | substantive | construction | recruiter | localization
flag waving | jingoism | flag | waving | emblem | wave | secularism | virion
gold rush | godsend | gold | rush | golden | haste | rejoinder | collectible
knee bend | squat | knee | bend | genu | crook | veronica | soda
bathing costume | swimsuit | bathing | costume | diversion | attire | candidacy | deportation
paying attention | attentiveness | paying | attention | gainful | attending | daughter | chiropractor
parathyroid hormone | parathormone | parathyroid | hormone | endocrine | tetragram | ebullience | ditch
mule driver | muleteer | mule | driver | equine | operator | tramp | preciousness
physical therapy | physiotherapy | physical | therapy | shinny | lending | propensity | gallop
anaerobic exercise | bodybuilding | anaerobic | exercise | exercising | pervert | precondition | vodoun
peritoneal inflammation | peritonitis | peritoneal | inflammation | redness | export | klystron | squint
glandular fever | mononucleosis | glandular | fever | pyrexia | thermoplastic | patency | epidemiologist
speed indicator | speedometer | speed | indicator | velocity | index | girandole | koto
bacillary dysentery | shigellosis | bacillary | dysentery | redbone | virga | straggler | conspiracy
page number | pagination | page | number | leaf | figure | glucagon | traineeship
stage dancing | choreography | stage | dancing | phase | dance | flypaper | mendicity
dressing down | castigation | dressing | down | sauce | feather | hacienda | tuille
psychological operation | psyop | psychological | operation | action | gynarchy | boulevard | tibialis
factory farm | agribusiness | factory | farm | mill | workplace | ductility | hobbler
cattle thief | rustler | cattle | thief | cows | stealer | gadabout | lamp
beau ideal | paragon | beau | ideal | boyfriend | idea | fusillade | monocot
flightless bird | ratite | flightless | bird | vertebrate | soundlessness | wistaria | transistor
brake light | stoplight | brake | light | restraint | saucepan | viceroy | masdevallia
foster child | fosterling | foster | child | songwriter | kid | deputy | frizz
sun blocker | sunscreen | sun | blocker | star | unreality | ingrate | breeziness
redirect examination | reexamination | redirect | examination | scrutiny | queerness | oestriol | horseman
cookery book | cookbook | cookery | book | cooking | publication | articulatio | impediment
pulmonary tuberculosis | phthisis | pulmonary | tuberculosis | pneumonic | offside | pasteurisation | husbandman
jawless fish | agnathan | jawless | fish | hutment | mall | troublemaker | lecturing
native land | fatherland | native | land | indigen | borderline | jacks | gallows
wood lily | trillium | wood | lily | mortice | lucubration | dossal | deformity
yellow poplar | whitewood | yellow | poplar | yellowness | wood | isotope | possessor
spinal column | spine | spinal | column | file | interlanguage | mononucleosis | keynote
dirty dog | rotter | dirty | dog | soiled | canine | roc | dandyism
live wire | sharpie | live | wire | unrecorded | ligament | uraninite | hyperpigmentation
camping ground | campsite | camping | ground | encampment | land | lesion | demarcation
papillary tumor | papilloma | papillary | tumor | papillose | tumour | geography | underpass
major league | majors | major | league | conference | placentation | tonic | towrope
full dress | tailcoat | full | dress | frock | tailwind | otherness | jostling
tail coat | tails | tail | coat | process | overgarment | meteor | pretension
confidential information | steer | confidential | information | info | greensward | reconnaissance | anticholinesterase
water bird | waterfowl | water | bird | liquid | vertebrate | illumination | patter
love affair | romance | love | affair | emotion | matter | night | sustentation
goose skin | gooseflesh | goose | skin | tegument | incineration | spire | cruelness
bronchial tube | bronchus | bronchial | tube | tubing | radome | importing | jasper
warning signal | alarum | warning | signal | informing | signaling | infestation | warden
space vehicle | spacecraft | space | vehicle | infinite | conveyance | tippler | dissolving
potato pancake | latke | potato | pancake | murphy | flapjack | tabloid | remount
air power | aviation | air | power | gas | powerfulness | tameness | dashboard
baking soda | saleratus | baking | soda | salt | forger | sawmill | subvention
giving up | yielding | giving | up | gift | ivory | spymaster | gleaner
eye infection | sty | eye | infection | oculus | traveler | resurgence | maidenhead
part name | meronym | part | name | portion | ephemeris | mammalian | bocci
candle flame | candlelight | candle | flame | taper | fire | beachwear | vagina
sensory nerve | afferent | sensory | nerve | centripetal | nervus | rudeness | monoplegia
unwelcome guest | gatecrasher | unwelcome | guest | invitee | tinkerer | tsaritsa | buy
petroleum jelly | petrolatum | petroleum | jelly | crude | gelatin | sleeplessness | homogeneousness
water plant | hydrophyte | water | plant | liquid | works | romanticisation | humaneness
wash room | restroom | wash | room | area | allurement | topee | wadi
epithelial tissue | epithelium | epithelial | tissue | stockhorn | cyclohexanol | incisiveness | lakh
rapid growth | zoom | rapid | growth | waterway | growing | taekwondo | bleakness
crack shot | marksman | crack | shot | cleft | shooting | isomerisation | biomedicine
odd fish | kook | odd | fish | uneven | exotherm | servicing | determinateness
black diamond | carbonado | black | diamond | blackness | jewel | airship | legislator
moral sense | conscience | moral | sense | lesson | awareness | potage | dowse
ship biscuit | hardtack | ship | biscuit | vessel | compliments | snore | bedwetter
epiphytic plant | epiphyte | epiphytic | plant | works | season | inflaming | abducens
judicial proceeding | litigation | judicial | proceeding | proceedings | woodfern | lectureship | cred
military plane | warplane | military | plane | force | airplane | planer | evasion
pipe fitter | plumber | pipe | fitter | tube | tailor | hermaphrodism | priesthood
first appearance | introduction | first | appearance | rank | quality | turnpike | impinging
jumping gene | transposon | jumping | gene | cistron | weatherman | self | cinch
female horse | mare | female | horse | animal | equine | ephemerid | redness
sex bomb | sexpot | sex | bomb | weaponry | phosphatase | phenyltoloxamine | judge
mountain climber | mountaineer | mountain | climber | mount | vine | ascot | tricyclic
electric eye | photocell | electric | eye | car | oculus | collapse | grog
spider mite | tetranychid | spider | mite | arachnid | touch | wagtail | gash
gallows tree | gibbet | gallows | tree | opiate | scintilla | curb | ramus
creek bed | streambed | creek | bed | brook | chef | ides | barracuda
bar sinister | bastardy | bar | sinister | barroom | electrode | dependability | discount
dog sleigh | dogsled | dog | sleigh | canine | sled | continuo | mezzotint
intelligence officer | operative | intelligence | officer | ability | serviceman | simoon | baritone
bog moss | sphagnum | bog | moss | wetland | bryophyte | taxon | seasoning
head ache | cephalalgia | head | ache | caput | aching | exhibition | tellurian
bay window | potbelly | bay | window | embayment | framework | sinusitis | wretchedness
small fry | squirt | small | fry | little | painter | series | friendliness
wage increase | raise | wage | increase | pay | addition | foredge | judgement
purplish pink | solferino | purplish | pink | purple | penuriousness | bimonthly | pseudoscorpion
male child | boy | male | child | animal | kid | dura | migrant
cotton candy | candyfloss | cotton | candy | confect | prickling | esotropia | woollen
good luck | luckiness | good | luck | advantage | fortune | weariness | straightaway
ground cloth | groundsheet | ground | cloth | land | fabric | hair | wainscoting
chump change | chickenfeed | chump | change | fool | alteration | gulden | katharsis
rough water | choppiness | rough | water | site | liquid | potoroo | deputy
dress suit | tailcoat | dress | suit | frock | garment | rhombohedron | whiptail
grape sugar | dextrose | grape | sugar | sweetening | tray | biophysicist | improbability
learning ability | brainpower | learning | ability | acquisition | quality | downstage | offshoot
butyl alcohol | butanol | butyl | alcohol | group | intoxicant | plunge | repairer
car maker | automaker | car | maker | auto | shaper | spiderwort | lemniscus
poster color | tempera | poster | color | posting | colour | cardiopathy | offshoot
camping area | campsite | camping | area | encampment | country | plier | unprofitability
love child | illegitimate | love | child | emotion | kid | eater | spirometer
personal appeal | charisma | personal | appeal | entreaty | disconnectedness | dynamometer | net
judicial system | judicatory | judicial | system | instrumentality | bollard | quad | bacitracin
milk cow | milcher | milk | cow | beverage | cattle | professionalization | foal
broken wind | heaves | broken | wind | weather | lapboard | radiophone | polyethylene
broadcast medium | broadcasting | broadcast | medium | message | instrumentality | frequency | folio
common person | commoner | common | person | park | individual | afterimage | haemodialysis
sixteenth note | semiquaver | sixteenth | note | rank | moderate | reciprocation | stridulation
creatine phosphate | phosphocreatine | creatine | phosphate | creatin | orthophosphate | guy | emoticon
ginger nut | gingersnap | ginger | nut | herb | seed | toucher | ultrasonography
quick temper | irascibility | quick | temper | area | pique | biriani | graininess
decision making | deciding | decision | making | determination | devising | bigeye | warplane
combat ship | warship | combat | ship | battle | vessel | geochemistry | rhinoscopy
animate being | animal | animate | being | beingness | ringmaster | mahout | embossment
side order | entremets | side | order | region | command | exclusive | microscopist
given name | forename | given | name | presumption | bidet | panoply | haft
muscle system | musculature | muscle | system | musculus | instrumentality | walking | hecatomb
superstitious notion | superstition | superstitious | notion | impression | mirid | tortricid | rift
anal sex | sodomy | anal | sex | melter | smirch | aniseed | phantasma
taxonomic category | taxon | taxonomic | category | taxonomical | class | bolete | beneficiation
plug hat | derby | plug | hat | stopper | chapeau | seventeenth | glossa
thiamine pyrophosphate | cocarboxylase | thiamine | pyrophosphate | thiamin | salt | transept | backgrounding
sexual activity | sex | sexual | activity | act | wirework | triangularity | gearing
depth psychology | psychoanalysis | depth | psychology | deepness | science | sporocarp | bock
political theory | ideology | political | theory | explanation | tragedy | cuneus | elitist
working day | workday | working | day | workings | polyneuritis | deregulation | verb
undercover agent | spy | undercover | agent | clandestine | highwayman | keratin | warming
visual image | visualization | visual | image | ocular | representation | fever | graining
female circumcision | clitoridectomy | female | circumcision | animal | subsistence | tortfeasor | thread
lunch period | lunchtime | lunch | period | luncheon | selling | pollen | cut
segmented worm | annelid | segmented | worm | metameric | invertebrate | seek | hyperlink
camping site | campsite | camping | site | encampment | tract | spic | imperium
botanical medicine | phytotherapy | botanical | medicine | drug | balloting | jointer | bollard
inexperienced person | innocent | inexperienced | person | individual | vernacular | arsonist | yack
complex quantity | imaginary | complex | quantity | composite | measure | psycholinguistics | bottlecap
census taker | enumerator | census | taker | count | customer | untimeliness | dotage
wise man | mentor | wise | man | manner | male | pachisi | intellectual
property master | propman | property | master | belongings | maestro | fieldsman | procrastination
long plane | jointer | long | plane | airplane | speech | abnormality | formalisation
squad car | cruiser | squad | car | auto | narc | pushiness | halftime
omnidirectional range | omnirange | omnidirectional | range | scope | niggardliness | lazaret | elite
gem clip | paperclip | gem | clip | treasure | magazine | obligato | fishpond
unmarried man | bachelor | unmarried | man | single | male | pigeonholing | enchantment
film producer | filmmaker | film | producer | movie | manufacturer | doxology | dyscrasia
tree surgeon | arborist | tree | surgeon | sawbones | infantryman | melodiousness | astrantia
structural linguistics | structuralism | structural | linguistics | science | triglyceride | minuscule | sequela
waste pipe | drainpipe | waste | pipe | material | tube | freeware | sputum
geographic expedition | exploration | geographic | expedition | geographical | campaign | skinniness | recession
air hammer | jackhammer | air | hammer | gas | cock | pyralid | hematemesis
common people | folk | common | people | park | group | vindictiveness | triplicity
beer maker | brewer | beer | maker | brew | shaper | dl | eosinophil
water nymph | naiad | water | nymph | liquid | groupie | coma | simulator
auto manufacturer | carmaker | auto | manufacturer | car | maker | obsolescence | flutter
lamp housing | lamphouse | lamp | housing | lodging | meritocracy | signpost | warranty
reinforced concrete | ferroconcrete | reinforced | concrete | strengthened | paving | pacifism | webbing
fungal infection | mycosis | fungal | infection | fungous | boarding | rapier | podocarp
tidy sum | hatful | tidy | sum | receptacle | amount | mezereum | tempering
violin bow | fiddlestick | violin | bow | fiddle | bowknot | tightening | myringoplasty
tree tomato | tamarillo | tree | tomato | cesspit | googol | cladding | diddley
spiritual domain | unseen | spiritual | domain | religious | sphere | anomy | whaler
axial rotation | roll | axial | rotation | motion | genre | strikeout | oxcart
mental case | neurotic | mental | case | instance | compressor | knapweed | motet
integrated circuit | microcircuit | integrated | circuit | incorporate | signet | semi | win
calcium oxide | quicklime | calcium | oxide | compound | peonage | hat | jug
going under | foundering | going | under | departure | demyelination | disenfranchisement | psychoneurosis
public exposure | dissemination | public | exposure | populace | vulnerability | internment | mushiness
horny layer | corneum | horny | layer | aroused | bed | stroboscope | androsterone
back pack | knapsack | back | pack | dorsum | battalion | ductility | gaming
practical joker | prankster | practical | joker | jokester | predilection | tetracaine | smallness
piezoelectric effect | piezoelectricity | piezoelectric | effect | consequence | otorhinolaryngology | quandary | glasshouse
ice fog | pogonip | ice | fog | crystal | aerosol | nationalist | tilling
union member | unionist | union | member | brotherhood | associate | dietician | goldenrod
loose woman | adulteress | loose | woman | female | eosin | chitterlings | escarp
bush baby | galago | bush | baby | shrub | babe | cockatrice | handmaid
sore throat | pharyngitis | sore | throat | infection | pharynx | vesiculitis | manual
short sleep | catnap | short | sleep | tract | slumber | phonics | polio
riding horse | mount | riding | horse | equitation | equine | world | workbench
electric light | lightbulb | electric | light | car | dragnet | advertizer | biophysics
nuclear chemistry | radiochemistry | nuclear | chemistry | atomic | demarche | engraver | esteem
fourth power | biquadratic | fourth | power | rank | powerfulness | salinity | modelling
black bread | pumpernickel | black | bread | blackness | breadstuff | snobbism | twin
air plant | epiphyte | air | plant | gas | works | segno | crotalaria
enteric fever | typhoid | enteric | fever | enteral | pyrexia | station | beany
variety meat | organs | variety | meat | assortment | food | hyaena | covering
burial chamber | sepulcher | burial | chamber | entombment | enclosure | bacteremia | dissymmetry
offensive activity | offense | offensive | activity | offence | act | proctorship | lipid
junk heap | scrapheap | junk | heap | debris | pile | countermine | hamartia
graphic symbol | grapheme | graphic | symbol | picture | signal | quicky | tub
sporting house | whorehouse | sporting | house | clean | dwelling | orography | quizzer
thermonuclear warhead | nuke | thermonuclear | warhead | payload | ruralist | programing | primus
inside information | details | inside | information | interior | info | pillage | antidiuretic
amphibious vehicle | amphibian | amphibious | vehicle | conveyance | basilica | bed | batter
computing machine | computer | computing | machine | engineering | device | tetherball | councilman
space travel | spaceflight | space | travel | infinite | traveling | ukase | creeps
frying pan | frypan | frying | pan | sauteing | technophile | tetrafluoroethylene | jitters
minor premiss | subsumption | minor | premiss | child | premise | hl | calf
iron carbide | cementite | iron | carbide | cartographer | expenditure | hubcap | fiber
good temper | amiability | good | temper | advantage | pique | weeper | nought
nest egg | savings | nest | egg | ovum | lapidation | hothouse | unification
running light | sidelight | running | light | run | pothouse | acculturation | crucifix
big toe | hallux | big | toe | large | digit | asyndeton | neuroepithelioma
butterfly collector | lepidopterist | butterfly | collector | aggregator | raft | angulation | wineskin
tympanic cavity | tympanum | tympanic | cavity | pit | ashcan | cerate | shrink
mucous membrane | mucosa | mucous | membrane | mucose | sheet | macron | musette
rain cloud | nimbus | rain | cloud | rainfall | mudslinger | mountainside | interloper
tummy tuck | abdominoplasty | tummy | tuck | pot | comestible | snickersnee | boardwalk
umbilical hernia | omphalocele | umbilical | hernia | duct | herniation | manganite | reapportionment
drinking fountain | bubbler | drinking | fountain | imbibing | structure | orchestra | amphetamine
line drawing | limning | line | drawing | formation | artwork | pluralisation | impermeability
dry socket | alveolitis | dry | socket | prohibitionist | cavity | amortization | solo
breaking away | breakaway | breaking | away | breakage | pulverization | electrocautery | humanity
free lance | freelancer | free | lance | people | spear | suzerain | aquifer
aerobic exercise | aerobics | aerobic | exercise | exercising | ethnography | voussoir | cosmea
lamp oil | kerosene | lamp | oil | lipid | thermogram | streptokinase | bookshelf
legislative body | legislature | legislative | body | strayer | pelican | nailhead | tritium
fore edge | foredge | fore | edge | bow | border | lacteal | vindication
taking apart | dismemberment | taking | apart | pickings | shrub | fearfulness | cerecloth
sense datum | sensation | sense | datum | awareness | information | detritus | paralogism
spelling bee | spelldown | spelling | bee | orthography | religiosity | spritzer | arthrography
herbaceous plant | herb | herbaceous | plant | works | cutthroat | scratch | knottiness
orange red | scarlet | orange | red | citrus | redness | vamp | clambake
potassium hydroxide | potash | potassium | hydroxide | compound | clomipramine | weekend | biosafety
country dancing | contredanse | country | dancing | state | dance | detox | crucifer
thin person | scrag | thin | person | individual | tiler | fortuity | cent
lunar month | lunation | lunar | month | cardia | expectedness | therapsid | pigmentation
ethnic group | ethnos | ethnic | group | person | grouping | probenecid | strawman
big league | majors | big | league | large | conference | endurance | revocation
skin eruption | exanthem | skin | eruption | tegument | discharge | ticktack | kasha
rock salt | halite | rock | salt | stone | compound | compromise | gean
vaulting horse | buck | vaulting | horse | structure | equine | pyrrhotite | fetor
telephone operator | telephonist | telephone | operator | phone | function | zillion | switcher
container vessel | containership | container | vessel | instrumentality | vas | parhelion | autoradiograph
nerve cell | neuron | nerve | cell | nervus | compartment | idiocy | peignoir
philosophical system | doctrine | philosophical | system | philosophic | instrumentality | ecliptic | herrerasaurus
violent disorder | rampage | violent | disorder | upset | altercation | kangaroo | haemorrhage
hydrogen carbonate | bicarbonate | hydrogen | carbonate | gas | salt | speakership | crooning
clothes peg | clothespin | clothes | peg | apparel | nog | palingenesis | strip
rabbit fever | tularemia | rabbit | fever | coney | pyrexia | malingerer | hutment
pitch black | ebony | pitch | black | blackness | caitiff | limestone | raster
botulinus toxin | botulin | botulinus | toxin | botulinum | poison | ptyalin | drift
incandescent lamp | lightbulb | incandescent | lamp | extrasystole | roofing | disputation | towny
cream pitcher | creamer | cream | pitcher | pick | hurler | gleaming | joystick
parallel processing | multiprocessing | parallel | processing | analogue | process | streptomycin | undoer
flat wash | flatwork | flat | wash | plain | fantast | teras | indicative
black book | blacklist | black | book | blackness | publication | skank | etiology
passenger car | carriage | passenger | car | rider | auto | immunohistochemistry | trumping
major tranquilizer | antipsychotic | major | tranquilizer | tranquillizer | octroi | ironware | propman
whipping boy | scapegoat | whipping | boy | tanning | male | tampering | codger
medical record | anamnesis | medical | record | checkup | evidence | ware | pollutant
voice box | larynx | voice | box | sound | container | placidity | satisfactoriness
pith helmet | topee | pith | helmet | bettor | snapshot | fiction | conceptuality
figured bass | continuo | figured | bass | pitch | doggie | sigmoidoscope | transcription
dead person | deceased | dead | person | people | individual | plantsman | salmagundi
gypsum board | plasterboard | gypsum | board | mineral | committee | merestone | ballooning
commanding officer | commandant | commanding | officer | dominating | serviceman | shortcake | occlusion
breathing in | inhalation | breathing | in | respiration | inch | ballottement | elaterid
south wind | souther | south | wind | weather | chicle | khadi | vibrion
glandular disease | adenosis | glandular | disease | illness | monomaniac | developing | subnormality
zirconium dioxide | zirconia | zirconium | dioxide | oxide | sexagenarian | jazzman | sneezeweed
flower gardening | floriculture | flower | gardening | angiosperm | horticulture | canticle | submitter
vertebral column | spine | vertebral | column | file | rainwater | tempura | yardie
small change | chickenfeed | small | change | little | alteration | escallop | cybernaut
grace note | appoggiatura | grace | note | state | ponce | backpack | frill
milch cow | milcher | milch | cow | cattle | experimentation | anlage | polymyositis
holistic theory | holism | holistic | theory | explanation | destruction | savagery | immoderation
investment banker | underwriter | investment | banker | investing | financier | hunting | autacoid
telephone directory | phonebook | telephone | directory | phone | astronaut | midline | bandleader
alluvial sediment | alluvium | alluvial | sediment | deposit | insured | dick | remainder
carbon black | lampblack | carbon | black | blackness | protectiveness | duffer | dint
overhead railway | elevated | overhead | railway | expense | railroad | falseness | hyperpyrexia
emery paper | sandpaper | emery | paper | mineral | material | graffiti | artfulness
orchid cactus | epiphyllum | orchid | cactus | flower | succulent | demand | crafter
station keeper | deskman | station | keeper | facility | defender | unemployed | limit
muscle sense | kinesthesis | muscle | sense | musculus | awareness | impulse | receipts
sweet sorghum | sorgo | sweet | sorghum | phonetician | millet | words | dishwater
auto maker | carmaker | auto | maker | car | shaper | typification | balustrade
air lane | skyway | air | lane | gas | way | wangler | dousing
behavioristic psychology | behaviorism | behavioristic | psychology | behaviorist | science | christella | mucoid
little finger | pinkie | little | finger | small | digit | arrivederci | suppleness
fish tank | aquarium | fish | tank | hypsography | hyalinization | lady | miter
quick fix | quickie | quick | fix | area | hole | conveyor | hoard
peaked cap | kepi | peaked | cap | ailing | headdress | salutation | dodging
fancy man | pimp | fancy | man | illusion | male | neoliberalism | striper
rock garden | rockery | rock | garden | stone | plot | hyphen | dislike
stone fruit | drupe | stone | fruit | rock | zipper | crispiness | subsidization
bird shot | buckshot | bird | shot | vertebrate | shooting | footrace | performer
paper bag | sack | paper | bag | material | container | explanation | superiority
trade name | brand | trade | name | commerce | librettist | dice | webfoot
air sac | alveolus | air | sac | gas | pouch | yanker | quadrivium
criminal conversation | adultery | criminal | conversation | felon | speech | valentine | frangipane
sense experience | sensation | sense | experience | awareness | education | sonograph | butchery
type specimen | holotype | type | specimen | kind | example | patch | backlog
recording machine | recorder | recording | machine | signal | device | waxing | sweetmeat
clothing store | haberdashery | clothing | store | vesture | shop | gastroenterologist | congee
abandoned infant | foundling | abandoned | infant | derelict | baby | puppeteer | deviant
feather star | comatulid | feather | star | plume | soberness | quilting | rinse
rumpus room | playroom | rumpus | room | commotion | area | arduousness | hookup
culinary art | cuisine | culinary | art | creation | newspaperwoman | thumbhole | pontificate
old person | oldster | old | person | past | individual | leather | repetition
insect powder | insecticide | insect | powder | arthropod | pulverization | taxidermist | momentousness
personal property | personalty | personal | property | belongings | parabola | woollen | rouble
small talk | chitchat | small | talk | little | talking | admonishment | nystagmus
mother superior | abbess | mother | superior | parent | superordinate | geyser | thinning
waking up | awakening | waking | up | consciousness | demodulator | radiotelephone | internationalisation
calcium hydroxide | lime | calcium | hydroxide | compound | tar | rascality | electrologist
ore processing | beneficiation | ore | processing | mineral | process | resort | hay
blood fluke | schistosome | blood | fluke | luck | sickbay | crupper | recusancy
false fruit | pome | false | fruit | actress | shade | inlet | trough
inverse tangent | arctangent | inverse | tangent | opposite | castrato | caladium | letting
dry wall | wallboard | dry | wall | prohibitionist | partition | singing | tatterdemalion
influence peddler | fixer | influence | peddler | power | pedlar | genipa | steatocystoma
somatosensory system | somesthesis | somatosensory | system | instrumentality | deliverance | lamination | weighbridge
writing table | escritoire | writing | table | authorship | array | vindicator | virtu
memorial park | cemetery | memorial | park | commemoration | parkland | gangsta | sanatorium
hierarchical menu | submenu | hierarchical | menu | hierarchal | card | pung | integrality
decompression sickness | bends | decompression | sickness | decoding | illness | perfectionism | ragamuffin
national leader | statesman | national | leader | subject | person | sprawler | fraternization
crossed eye | esotropia | crossed | eye | oculus | validity | starer | setup
legal assistant | paralegal | legal | assistant | helper | hopefulness | synchronizing | expose
silver salmon | coho | silver | salmon | conductor | salmonid | receiver | beautician
sea cow | sirenian | sea | cow | cattle | informant | variolation | cordgrass
way station | stopover | way | station | manner | facility | earlobe | ambiguity
bull fiddle | contrabass | bull | fiddle | cattle | violin | jobholder | annalist
cardiopulmonary arrest | asystole | cardiopulmonary | arrest | cardiorespiratory | apprehension | haemangioma | dynamics
fiber bundle | fasciculus | fiber | bundle | fibre | package | leveling | snaffle
tree line | timberline | tree | line | formation | paneling | ungratefulness | deviationism
farm animal | livestock | farm | animal | workplace | beast | locoweed | wordnet
death penalty | execution | death | penalty | decease | punishment | townie | quatrain
young lady | girl | young | lady | offspring | woman | adnexa | kidney
grave mound | tumulus | grave | mound | death | hill | polypeptide | infant
one shot | round | one | shot | ace | shooting | bends | demiurge
red lead | minium | red | lead | redness | advantage | graphite | interregnum
question master | quizmaster | question | master | inquiry | maestro | gnomon | paleographer
leading light | luminary | leading | light | lead | sialadenitis | teakettle | schistosomiasis
sea cucumber | holothurian | sea | cucumber | melon | scantiness | fossa | chickenpox
inductive reasoning | generalization | inductive | reasoning | thinking | dogsled | arcella | sensationalism
mosquito hawk | dragonfly | mosquito | hawk | aberrant | civet | cleome | proliferation
standard pressure | atm | standard | pressure | criterion | dissimulation | anaerobe | blanc
sea moss | bryozoan | sea | moss | bryophyte | patrol | thorite | resection
mass meeting | rally | mass | meeting | aggregate | gathering | secularist | pluralism
great ape | pongid | great | ape | achiever | primate | hardback | histologist
public violence | riot | public | violence | populace | force | ostinato | landowner
pocket bread | pita | pocket | bread | pouch | breadstuff | jaeger | scorecard
deep red | crimson | deep | red | middle | redness | novelist | translucency
tenpin bowling | tenpins | tenpin | bowling | game | wikiup | drop | housemaster
visceral pericardium | epicardium | visceral | pericardium | splanchnic | gastroscopy | palpebra | discursiveness
publishing house | publisher | publishing | house | publication | dwelling | falanga | cheating
value orientation | ethic | value | orientation | placement | aptitude | heavy | ignition
sport jacket | blazer | sport | jacket | athletics | coat | candela | lucidity
heavy hydrogen | deuterium | heavy | hydrogen | actor | gas | amnesty | drainboard
growth regulator | phytohormone | growth | regulator | growing | control | finisher | subfigure
lexical ambiguity | polysemy | lexical | ambiguity | saying | symptom | registry | subsiding
handwriting expert | graphologist | handwriting | expert | hand | person | headman | predisposition
telephone service | telco | telephone | service | phone | work | paragonite | humdrum
cock sucking | blowjob | cock | sucking | prick | suck | jnd | dogleg
poster paint | tempera | poster | paint | posting | pigment | submergence | supplier
synovial joint | diarthrosis | synovial | joint | articulation | dualist | slut | reassurance
comfort station | restroom | comfort | station | comfortableness | facility | rauvolfia | dogsled
trash heap | scrapheap | trash | heap | rubbish | pile | meningioma | renovation
department store | emporium | department | store | section | shop | jennet | jammer
loan office | pawnshop | loan | office | debt | manioca | twang | breakers
grappling iron | grapnel | grappling | iron | wrestle | statement | llano | shmaltz
leguminous plant | legume | leguminous | plant | works | liking | granulocyte | styler
pedestrian bridge | footbridge | pedestrian | bridge | walker | span | halogen | marzipan
prairie fire | grassfire | prairie | fire | grassland | happening | prefecture | dissolution
sign language | signing | sign | language | mark | communication | pica | ennoblement
family name | surname | family | name | household | wage | briefcase | decathlon
physical therapist | physiotherapist | physical | therapist | healer | ketone | tracer | elegist
pediculosis pubis | crabs | pediculosis | pubis | lousiness | bone | deterrent | humanitarian
tongue tie | ankyloglossia | tongue | tie | lingua | necktie | sweetheart | insolation
evening dress | formalwear | evening | dress | eve | frock | diplomat | timidness
rickettsial disease | rickettsiosis | rickettsial | disease | illness | slice | gunwale | bioscience
fat person | fatso | fat | person | lipid | individual | lagan | chordamesoderm
irresistible impulse | compulsion | irresistible | impulse | resistless | urge | sprit | lachrymator
horse barn | stable | horse | barn | equine | washout | propyl | dosimeter
black eye | shiner | black | eye | blackness | oculus | sociologist | stokehold
mouse mat | mousepad | mouse | mat | rodent | uniqueness | fibula | statuary
green lacewing | chrysopid | green | lacewing | greenness | anthropologist | penalisation | eosinophil
tea towel | dishtowel | tea | towel | beverage | portulaca | puissance | gripe
proteolytic enzyme | protease | proteolytic | enzyme | protein | everting | xylophonist | guess
sex gland | gonad | sex | gland | secretor | victimizer | adulteration | brattice
racial discrimination | racialism | racial | discrimination | favoritism | pantheist | phantom | burglary
land area | acreage | land | area | country | pentecostalism | microglia | sparring
motive power | locomotion | motive | power | motivation | powerfulness | slanguage | peristome
dust storm | duster | dust | storm | particulate | regency | commiseration | subtreasury
sheep pen | sheepfold | sheep | pen | bovid | annals | reliever | timepiece
sea bird | seafowl | sea | bird | vertebrate | fibril | contrariness | godsend
kinship group | kindred | kinship | group | affinity | grouping | achene | turnover
flying reptile | pterosaur | flying | reptile | flight | reptilian | caulk | national
capital punishment | execution | capital | punishment | assets | penalty | hypercellularity | basswood
simple fruit | bacca | simple | fruit | herb | transparency | redox | herbicide
honey eater | honeysucker | honey | eater | sweetening | feeder | mericarp | palisade
creative thinking | creativity | creative | thinking | originative | thought | nonbeing | silverside
zirconium oxide | zirconia | zirconium | oxide | compound | borderer | cockiness | monopsony
vertical fin | tailfin | vertical | fin | orientation | five | wrath | quiet
pilot bread | hardtack | pilot | bread | aviator | breadstuff | homeobox | overlayer
salary increase | raise | salary | increase | wage | addition | deck | pooch
drilling rig | oilrig | drilling | rig | boring | gear | solver | sente
trolley coach | trolleybus | trolley | coach | streetcar | manager | nibble | pickup
degenerative arthritis | osteoarthritis | degenerative | arthritis | cryostat | hesitation | rhymester | patchwork
flying gurnard | butterflyfish | flying | gurnard | flight | weatherman | matter | sec
technical school | tech | technical | school | pickup | oxyacid | araucaria | hotelkeeper
beer mug | stein | beer | mug | brew | clast | bedclothes | clutch
stable companion | stablemate | stable | companion | stalls | comrade | chenille | snoot
yellow journalism | tabloid | yellow | journalism | yellowness | jingle | subsection | urticaria
speech pattern | accent | speech | pattern | address | form | heteronym | analects
plutonic rock | batholith | plutonic | rock | irruptive | stone | eland | malacologist
performing artist | performer | performing | artist | acting | creator | suppresser | anathema
physical structure | body | physical | structure | construction | tiffin | hyperopia | lookup
first stomach | rumen | first | stomach | rank | tummy | margrave | basis
goat herder | goatherd | goat | herder | bovid | philosopher | expulsion | ileum
fairy story | fairytale | fairy | story | faery | narrative | melilotus | tallyman
sex kitten | sexpot | sex | kitten | kitty | epistle | backcloth | cleverness
mutual exclusiveness | incompatibility | mutual | exclusiveness | common | clannishness | espadrille | microspore
electric storm | thunderstorm | electric | storm | car | harbinger | totalism | tritoma
front tooth | anterior | front | tooth | forepart | bone | paleopathology | veranda
diacritical mark | diacritic | diacritical | mark | grade | bound | palisade | shipside
sweet gum | hazelwood | sweet | gum | phonetician | editorial | helminthic | milling
point lace | needlepoint | point | lace | component | lacing | chrisom | replacement
chalk line | snapline | chalk | line | calcite | formation | hutzpah | mining
dead room | morgue | dead | room | people | area | bagger | shipwreck
sound reflection | echo | sound | reflection | contemplation | slang | mining | sealskin
random variable | variate | random | variable | thing | palaetiology | hessonite | invalid
tail bone | coccyx | tail | bone | process | os | eyeglass | tosh
public speaker | orator | public | speaker | populace | talker | kitbag | axil
iron overload | hemochromatosis | iron | overload | load | crop | soteriology | capital
sun porch | sunroom | sun | porch | star | structure | kaffiyeh | limbers
deposit box | lockbox | deposit | box | sedimentation | container | sarcosine | olein
drawing pin | thumbtack | drawing | pin | artwork | jewelry | crapshooter | vertical
night owl | nighthawk | night | owl | nighttime | hooter | wet | quaestor
field hand | farmhand | field | hand | tract | manus | vampirism | laity
echo sounder | sonar | echo | sounder | reverberation | device | ink | owlet
grass widow | divorcee | grass | widow | woman | rhizomorph | sisterhood | wormhole
nine iron | niblick | nine | iron | niner | boxers | cancer | sealer
brown coal | lignite | brown | coal | brownness | viewgraph | programme | apiary
living space | lebensraum | living | space | life | infinite | ennoblement | saxophone
fresh fish | fodder | fresh | fish | orange | downhill | travelogue | tryptophan
stomach flu | gastroenteritis | stomach | flu | tummy | influenza | roster | functionary
wine waiter | sommelier | wine | waiter | vino | server | aliyah | dazzle
rail technology | railroading | rail | technology | railing | engineering | solicitation | organophosphate
life science | bioscience | life | science | being | discipline | scalenus | embrocation
dog days | canicule | dog | days | canine | years | epitope | plesiosaur
apple polisher | bootlicker | apple | polisher | pome | buffer | detergency | dauber
security review | censoring | security | review | safety | reappraisal | temporality | countercurrent
narrow margin | slimness | narrow | margin | strait | border | pessimist | much
biological weapon | bioweapon | biological | weapon | biologic | arm | vase | alkalinity
caffeine intoxication | caffeinism | caffeine | intoxication | caffein | poisoning | eclipsis | hyphen
eating place | restaurant | eating | place | feeding | spot | cappelletti | drafting
operating expense | overhead | operating | expense | disbursal | natrolite | nonappearance | cache
squirt gun | squirter | squirt | gun | cipher | weapon | shigella | borrelia
cubic metre | kiloliter | cubic | metre | meter | ink | ani | cupola
stomach upset | indigestion | stomach | upset | tummy | disturbance | neonatology | lecturer
service cap | kepi | service | cap | work | headdress | assuagement | director
shell collecting | conchology | shell | collecting | ammunition | collection | columnist | schoolteacher
wing case | elytron | wing | case | organ | instance | tranquillity | jean
spectrographic analysis | spectroscopy | spectrographic | analysis | investigation | imperishableness | dale | apology
reflection factor | reflectance | reflection | factor | contemplation | cause | noggin | syncope
steel plant | steelworks | steel | plant | alloy | works | importing | whisker
dairy cow | milcher | dairy | cow | farm | cattle | responder | lemma
inhuman treatment | cruelty | inhuman | treatment | cold | intervention | tactfulness | counterespionage
copy editor | copyreader | copy | editor | transcript | craving | polybutylene | magic
high spot | highlight | high | spot | degree | place | knacker | immunosuppression
measuring worm | inchworm | measuring | worm | measurement | invertebrate | specialiser | pillage
pleasure ground | funfair | pleasure | ground | pleasance | land | spotlight | nape
water fountain | bubbler | water | fountain | liquid | structure | sewerage | inconsiderateness
time lag | delay | time | lag | clip | slowdown | crocus | speediness
tool cabinet | toolbox | tool | cabinet | implement | furniture | stardust | aesthetic
body suit | leotard | body | suit | garment | echo | hippodrome | swimmeret
exercise bike | exercycle | exercise | bike | exercising | motorcycle | phony | polytonality
squeeze box | accordion | squeeze | box | squeezing | container | maths | sugarcane
engineering school | polytechnic | engineering | school | technology | appeal | solvent | lyricism
weed killer | herbicide | weed | killer | slayer | ambage | acrylonitrile | semiconsciousness
human death | fatality | human | death | homo | decease | grandson | diamond
old maid | spinster | old | maid | past | maidservant | worst | puss
plantation owner | planter | plantation | owner | estate | proprietor | epiglottitis | blackwater
clasp knife | jackknife | clasp | knife | fastener | rollmops | moulding | pooch
ammonium hydroxide | ammonia | ammonium | hydroxide | compound | drugget | jar | tomentum
northwest wind | northwester | northwest | wind | northwestern | weather | agglutinin | bonhomie
retirement pension | superannuation | retirement | pension | status | rhagades | troublemaker | sixpack
silent movie | silents | silent | movie | soundless | film | devitalization | countenance
upset stomach | indigestion | upset | stomach | disturbance | tummy | nestle | gean
road agent | highwayman | road | agent | route | ligation | rake | cornu
stunt flying | aerobatics | stunt | flying | feat | flight | biceps | microphallus
wool grease | lanolin | wool | grease | woolen | oil | divvy | bridgework
flick knife | switchblade | flick | knife | contact | degeneration | banger | coauthor
enlarged heart | cardiomegaly | enlarged | heart | hypertrophied | bosom | caffein | tenosynovitis
maintenance man | repairman | maintenance | man | care | male | pataca | horsewhip
insect repellant | insectifuge | insect | repellant | arthropod | repellent | foundering | primitive
common man | commoner | common | man | park | male | cony | spite
mixed bag | assortment | mixed | bag | assorted | container | opprobrium | trolley
sleeping around | promiscuity | sleeping | around | sleep | interlock | scarcity | shortbread
garden cart | wheelbarrow | garden | cart | plot | wagon | recompense | rattler
married person | spouse | married | person | individual | kylie | remembrance | likeness
film making | moviemaking | film | making | movie | devising | canker | afghani
methyl alcohol | methanol | methyl | alcohol | alkyl | intoxicant | millinery | ichthyosis
gland disease | adenosis | gland | disease | secretor | illness | hybridisation | adobe
eclectic method | eclecticism | eclectic | method | philosopher | crore | huckster | vagabond
main course | entree | main | course | briny | class | sensitivity | tributary
cloud cover | cloudiness | cloud | cover | screen | nervus | flats | naan
cutting tool | cutlery | cutting | tool | edged | implement | merger | flyspeck
nuclear submarine | nautilus | nuclear | submarine | atomic | sub | critic | mountaineering
spectrum analysis | spectroscopy | spectrum | analysis | array | investigation | squeezer | arpent
brain surgeon | neurosurgeon | brain | surgeon | encephalon | sawbones | swad | doghouse
creative activity | creation | creative | activity | originative | act | tier | lyricism
first balcony | mezzanine | first | balcony | rank | structure | drumstick | finger
picture tube | kinescope | picture | tube | image | tubing | kernite | sternocleidomastoid
attractive force | attraction | attractive | force | influence | associationism | cutter | flier
tragic flaw | hamartia | tragic | flaw | tragical | defect | nudibranch | muramidase
mineral processing | beneficiation | mineral | processing | material | process | eyesight | bonus
water sport | aquatics | water | sport | liquid | athletics | shuck | carabineer
methodological analysis | methodology | methodological | analysis | investigation | expansiveness | misunderstanding | tie
hat shop | millinery | hat | shop | chapeau | store | bough | distich
existential philosophy | existentialism | existential | philosophy | experiential | doctrine | cyclotron | deregulation
medicinal drug | medication | medicinal | drug | agent | climax | mandatory | pinkroot
spear carrier | extra | spear | carrier | lance | bearer | antihypertensive | year
heroic poem | epic | heroic | poem | reverse | overmuch | noviciate | nones
publishing firm | publisher | publishing | firm | publication | house | genome | amethopterin
middle watch | midwatch | middle | watch | center | ticker | pya | lipoprotein
slave trader | slaver | slave | trader | person | bargainer | integration | mujahadin
baby buggy | perambulator | baby | buggy | babe | roadster | hagiology | earthstar
magnetic attraction | magnetism | magnetic | attraction | force | spin | maulers | archdeaconry
elbow bone | ulna | elbow | bone | cubitus | os | bacon | enlistment
nonviolent resistance | nonviolence | nonviolent | resistance | opposition | scalenus | densitometry | photolithography
casting lots | sortition | casting | lots | cast | tons | verruca | orlop
kidney bean | frijol | kidney | bean | legume | grandstander | bull | rickshaw
living stone | lithops | living | stone | life | rock | wearing | toner
horse blanket | saddlecloth | horse | blanket | equine | cover | bulk | chapeau
double bassoon | contrabassoon | double | bassoon | dual | ashlar | competition | pharisee
choice morsel | tidbit | choice | morsel | pick | lemonwood | stayer | stern
pea jacket | peacoat | pea | jacket | legume | coat | wattmeter | atrium
wave shape | waveform | wave | shape | movement | form | moral | fervency
cat sleep | catnap | cat | sleep | feline | slumber | highflyer | repulse
tai chi | taichichuan | tai | chi | qi | gorge | hallelujah | fogey
desk sergeant | deskman | desk | sergeant | table | essay | phonophobia | bighead
recording equipment | recorder | recording | equipment | signal | instrumentality | rhubarb | osteochondroma
sleep talking | somniloquy | sleep | talking | slumber | talk | ancestry | steatite
slave owner | slaveholder | slave | owner | person | proprietor | conceiver | knife
sphinx moth | hawkmoth | sphinx | moth | person | arranger | prosthetics | consumer
air letter | aerogram | air | letter | gas | missive | panting | nausea
vertical stabilizer | tailfin | vertical | stabilizer | orientation | chemical | wintertime | flambeau
collard greens | collards | collard | greens | kale | green | lasher | anxiousness
sodium bicarbonate | saleratus | sodium | bicarbonate | carbonate | spacesuit | reiteration | entombment
political leader | politico | political | leader | person | retentiveness | owlet | nebula
phonograph recording | disc | phonograph | recording | machine | signal | printmaker | separability
muscle building | bodybuilding | muscle | building | musculus | edifice | yesteryear | ancestor
true bacteria | eubacteria | true | bacteria | alignment | bacterium | electromyography | pedophile
fire hydrant | fireplug | fire | hydrant | happening | tap | cracker | peplos
religious order | sect | religious | order | spiritual | command | cran | squirm
famous person | celebrity | famous | person | celebrated | individual | spondylolisthesis | civilization
real estate | realty | real | estate | existent | property | pteridology | splatter
post doc | postdoctoral | post | doc | station | doctor | footrest | intersex
nuclear chemist | radiochemist | nuclear | chemist | atomic | scientist | stabber | dating
belly laugh | guffaw | belly | laugh | abdomen | laughter | penalisation | botulin
stadium jumping | showjumping | stadium | jumping | bowl | basset | keno | barrier
saddle horse | mount | saddle | horse | seat | equine | heifer | clot
dental technician | denturist | dental | technician | alveolar | materiality | appliance | kowtow
candle holder | candlestick | candle | holder | taper | obstinance | pinkeye | spoor
end point | terminus | end | point | terminal | component | striptease | singing
service stripe | hashmark | service | stripe | work | band | slop | devices
air hose | airline | air | hose | gas | hosiery | torpedo | mealie
flying lemur | colugo | flying | lemur | flight | primate | untying | ailanthus
clay sculpture | modeling | clay | sculpture | soil | watercourse | psychometrika | naturopath
precious stone | jewel | precious | stone | cherished | rock | saleratus | sifter
tear gas | lacrimator | tear | gas | teardrop | anticonvulsant | peace | slogger
dawn horse | eohippus | dawn | horse | dawning | equine | gregarine | fight
resonating chamber | resonator | resonating | chamber | resonant | enclosure | snick | papilla
solitary wave | soliton | solitary | wave | confinement | movement | throne | godwit
goose egg | nothing | goose | egg | ovum | arthropathy | materialism | elf
mother wit | gumption | mother | wit | parent | humor | solvency | sternpost
visible radiation | light | visible | radiation | seeable | energy | champion | joke
mother country | fatherland | mother | country | parent | state | agency | craft
arc cosine | arccos | arc | cosine | discharge | cos | sprite | rill
storage room | storeroom | storage | room | retention | area | ostiole | chondrosarcoma
monkey dog | affenpinscher | monkey | dog | primate | canine | nickelodeon | gregariousness
club moss | lycopod | club | moss | nine | bryophyte | whizz | masquerader
geophysical science | geophysics | geophysical | science | discipline | mermaid | voile | everyman
trash can | ashcan | trash | can | rubbish | tin | abaya | colleen
fair weather | temperateness | fair | weather | carnival | conditions | quadrennium | glossa
sea slug | nudibranch | sea | slug | bullet | coursework | potentiometer | outlaw
cloud nine | bliss | cloud | nine | niner | packhorse | euphorbium | interoperability
fatality rate | deathrate | fatality | rate | death | mixologist | blurb | anomy
medical evacuation | medevac | medical | evacuation | checkup | emptying | paralanguage | grama
birthday suit | raw | birthday | suit | anniversary | garment | carack | kitchenette
tea parlor | teashop | tea | parlor | beverage | parlour | repugnance | pockmark
know nothing | ignoramus | know | nothing | knowing | nil | viscometer | cosmography
wood alcohol | methanol | wood | alcohol | intoxicant | bulldozer | sudor | ragtag
jazz musician | jazzman | jazz | musician | wind | instrumentalist | bullnose | naphthol
celestial navigation | astronavigation | celestial | navigation | heavenly | pilotage | pulley | hackle
dark glasses | sunglasses | dark | glasses | darkness | spectacles | duvet | albuginea
concert dance | ballet | concert | dance | performance | art | hemiplegic | salesclerk
mucous secretion | mucus | mucous | secretion | mucose | epilation | kaph | megasporangium
foundling hospital | creche | foundling | hospital | baby | infirmary | steadiness | issuing
elephant ear | alocasia | elephant | ear | proboscidean | maharajah | mesmerizer | crossroad
nuclear physics | nucleonics | nuclear | physics | atomic | smidgen | skeleton | dodderer
retirement check | superannuation | retirement | check | status | cheque | taxpayer | purging
hot stuff | voluptuousness | hot | stuff | material | pin | predetermination | enlightenment
digging up | exhumation | digging | up | excavation | microsecond | pharyngitis | oxide
fire opal | girasol | fire | opal | happening | mineral | stonewort | emmetropia
hunting expedition | safari | hunting | expedition | hunt | campaign | demister | beep
funeral director | mortician | funeral | director | ceremony | manager | stupor | southpaw
political orientation | ideology | political | orientation | placement | debasement | cleansing | counterinsurgency
gluteal muscle | gluteus | gluteal | muscle | musculus | deconstruction | simoom | sludge
spoken word | vocable | spoken | word | motet | doyley | carotenoid | rafter
clinical psychologist | psychotherapist | clinical | psychologist | scientist | quartile | qabalah | lubrication
school assignment | schoolwork | school | assignment | duty | scuff | mopes | twosome
eye tooth | canine | eye | tooth | oculus | bone | raceway | causing
garden truck | produce | garden | truck | plot | fundament | owlet | web
waiting line | queue | waiting | line | wait | formation | underdevelopment | serviceman
mental capacity | brainpower | mental | capacity | capability | redevelopment | carbuncle | cull
commercial traveler | roadman | commercial | traveler | ad | traveller | nabob | chalice
tree farming | arboriculture | tree | farming | agriculture | seminar | aalii | sociologist
multiple fruit | syncarp | multiple | fruit | product | jaggery | honey | hallux
cat burglar | housebreaker | cat | burglar | feline | thief | nonce | welcomer
health check | checkup | health | check | wellness | cheque | greenbelt | hotness
ore dressing | beneficiation | ore | dressing | mineral | sauce | unfaithfulness | floor
travelling salesman | roadman | travelling | salesman | travel | salesperson | lambskin | pirana
amusement park | funfair | amusement | park | delight | parkland | cyst | loophole
shooting iron | pistol | shooting | iron | shot | trypsin | swell | orthoclase
mental disease | psychopathy | mental | disease | illness | sporophore | congregating | incitation
political economy | economics | political | economy | system | arboretum | steelworker | snobbery
circular file | wastebasket | circular | file | handbill | record | renin | tide
operating cost | overhead | operating | cost | outgo | kroon | handbasket | nosegay
false hair | hairpiece | false | hair | metro | mako | clowder | pocketbook
theatrical production | staging | theatrical | production | representation | act | athlete | pluralist
hair style | hairdo | hair | style | manner | straightaway | accelerando | theory
flying bird | carinate | flying | bird | flight | vertebrate | leniency | clique
shot glass | jigger | shot | glass | shooting | solid | polymerase | cowherd
trade route | seaway | trade | route | commerce | path | lending | emerald
seeing red | huff | seeing | red | beholding | redness | smokehouse | quoter
finger grass | crabgrass | finger | grass | digit | constitutionalism | dislike | workings
combat zone | tenderloin | combat | zone | battle | conservation | monorail | theta
church member | churchgoer | church | member | religion | associate | assembler | overlayer
magnesium oxide | periclase | magnesium | oxide | compound | cavy | blackleg | native
cubic centimetre | milliliter | cubic | centimetre | centimeter | episcopacy | stirrup | fray
farm horse | dobbin | farm | horse | workplace | equine | edentate | sloven
dry mouth | xerostomia | dry | mouth | prohibitionist | rima | ether | rapaciousness
scratch awl | scriber | scratch | awl | abrasion | originality | priest | hardpan
flower people | hippies | flower | people | angiosperm | group | cordon | snowplough
breathing spell | breather | breathing | spell | respiration | enchantment | assagai | leiomyosarcoma
human ecology | demography | human | ecology | homo | environment | halberdier | prescript
hurdle race | hurdles | hurdle | race | barrier | contest | siltstone | aqueduct
sun parlour | sunporch | sun | parlour | star | parlor | musculature | sprinkle
contact action | catalysis | contact | action | interaction | act | succotash | burnup
long horse | buck | long | horse | equine | deli | otosclerosis | seignior
phone company | telco | phone | company | telephone | institution | printmaker | coiner
cleansing agent | cleanser | cleansing | agent | cleaning | polemonium | infrequency | divide
religious residence | cloister | religious | residence | spiritual | abode | gatekeeper | telamon
inflectional morphology | accidence | inflectional | morphology | biology | training | oviraptorid | reprimand
kidney disease | nephropathy | kidney | disease | illness | travelling | pyromancy | umpirage
bird food | birdseed | bird | food | vertebrate | nutrient | copilot | mako
native sulfur | brimstone | native | sulfur | indigen | sulphur | malingering | tastebud
armillary sphere | armilla | armillary | sphere | domain | retiree | gazania | thumbprint
material body | bod | material | body | stuff | boxful | swordplay | dogwatch
sleeping room | bedroom | sleeping | room | sleep | area | concupiscence | barrage
tent flap | rainfly | tent | flap | shelter | covering | cere | rippling
empiricist philosophy | empiricism | empiricist | philosophy | philosopher | doctrine | vacationer | moa
race murder | genocide | race | murder | contest | slaying | haemangioma | oncologist
migration route | flyway | migration | route | motion | path | bombie | hump
internal secretion | hormone | internal | secretion | nameplate | tinsel | cultivation | coffeepot
ballistic trajectory | ballistics | ballistic | trajectory | flight | granddaddy | fragrancy | forwardness
insect repellent | insectifuge | insect | repellent | arthropod | repellant | checkpoint | photopigment
turn indicator | trafficator | turn | indicator | bend | index | misogynist | meninges
legal guardian | trustee | legal | guardian | defender | whoopee | ebony | sulfate
sun helmet | topee | sun | helmet | star | karyokinesis | diminutiveness | linguistics
herb doctor | herbalist | herb | doctor | doc | fetich | bickering | brownness
coaxial cable | coax | coaxial | cable | cablegram | ump | mestranol | fault
sod house | soddy | sod | house | turf | dwelling | truce | crossness
confidence trick | bunco | confidence | trick | assurance | device | cataract | gauge
high quality | superiority | high | quality | degree | attribute | migration | motoneuron
plant hormone | phytohormone | plant | hormone | works | endocrine | realness | surrejoinder
skirting board | baseboard | skirting | board | encircling | committee | gainer | realism
resort area | playground | resort | area | hotel | country | butt | unresponsiveness
duck soup | cinch | duck | soup | dish | subshrub | ampere | executing
writing system | orthography | writing | system | authorship | instrumentality | eyetooth | skullduggery
tax collector | taxman | tax | collector | taxation | aggregator | shoeblack | butch
table linen | napery | table | linen | array | fabric | paternity | bigeye
human body | bod | human | body | homo | slippage | watchman | hands
skin color | complexion | skin | color | tegument | colour | journeyer | lurch
good humour | amiability | good | humour | advantage | temper | overbid | loader
snake eyes | craps | snake | eyes | serpent | opinion | varnisher | tuffet
titanium dioxide | titania | titanium | dioxide | oxide | gasfield | forager | eriogonum
day blindness | hemeralopia | day | blindness | sightlessness | friction | thrill | cerebration
forced feeding | gavage | forced | feeding | eating | frump | mustachio | thesaurus
wall painting | mural | wall | painting | partition | picture | judge | plum
educational activity | education | educational | activity | act | ampersand | phocomelia | sherbet
pants suit | pantsuit | pants | suit | bloomers | garment | sparrow | clothing
minor planet | planetoid | minor | planet | child | heterogeneity | grater | expectation
wind gauge | anemometer | wind | gauge | weather | gage | debility | watermeal
subject case | nominative | subject | case | topic | instance | rioter | concourse
bionic woman | cyborg | bionic | woman | female | divvy | reverberance | econometrics
baby bird | nestling | baby | bird | babe | vertebrate | hotbox | reveller
phone service | telco | phone | service | telephone | work | discordance | sociolinguistics
dairy farming | dairying | dairy | farming | farm | agriculture | roundel | buckeye
thorough bass | continuo | thorough | bass | pitch | breakage | aeronaut | excelsior
weather forecaster | weatherman | weather | forecaster | conditions | predictor | grass | irritation
physiological psychology | neuropsychology | physiological | psychology | science | curbstone | aging | secretion
continuous tense | progressive | continuous | tense | uninterrupted | chronology | botheration | fledgeling
smash hit | megahit | smash | hit | knock | feat | newlywed | benzoquinone
telephone book | phonebook | telephone | book | phone | publication | dysgenesis | cricketer
skin tumor | acanthoma | skin | tumor | tegument | tumour | impulsiveness | hollow
show window | showcase | show | window | entertainment | framework | whinny | woof
logical thinking | reasoning | logical | thinking | thought | criticalness | trichuriasis | taxer
stereoscopic vision | stereoscopy | stereoscopic | vision | imagination | howl | prosthetics | sheathing
cellular telephone | cellphone | cellular | telephone | phone | monstera | luncher | pimp
sex appeal | oomph | sex | appeal | entreaty | tackler | emissary | obduracy
ice ax | piolet | ice | ax | crystal | axe | phlogopite | stays
white horse | whitecap | white | horse | person | equine | resumption | pulverization
peace lily | spathiphyllum | peace | lily | order | anarchism | needy | beautician
bottom fish | groundfish | bottom | fish | underside | clams | size | jitteriness
setting hen | broody | setting | hen | scene | biddy | internationalism | conenose
chewing out | castigation | chewing | out | chew | failure | handcraft | military
soft touch | chump | soft | touch | touching | artiste | commonage | helmsman
cycle rickshaw | pedicab | cycle | rickshaw | rhythm | jinrikisha | oscillator | acquiescence
psychological disorder | folie | psychological | disorder | upset | tonic | scrummage | tenement
sugar apple | annon | sugar | apple | sweetening | pome | manoeuvrability | medevac
work stoppage | strike | work | stoppage | activity | arrest | oligochaete | intermediate
riding breeches | jodhpurs | riding | breeches | equitation | knickerbockers | adaption | release
wet nurse | amah | wet | nurse | moisture | biquadratic | tularemia | testimony
teaching method | pedagogics | teaching | method | instruction | secessionism | blocker | impress
batting order | lineup | batting | order | attempt | command | swindler | trick
intercommunication system | intercom | intercommunication | system | communication | instrumentality | ordainer | wrick
dirty money | loot | dirty | money | soiled | subordination | rosebud | shaker
missionary station | mission | missionary | station | teacher | facility | processional | sideline
labor coach | doula | labor | coach | labour | manager | stoolie | republic
visual perception | beholding | visual | perception | ocular | percept | destination | codon
pencil pusher | penpusher | pencil | pusher | thruster | voyage | pacifism | expunction
tail lamp | taillight | tail | lamp | process | leatherwork | fireman | steamfitter
piano player | pianist | piano | player | pianoforte | participant | there | render
hair ball | trichobezoar | hair | ball | translucency | travelog | powder | seeking
blue stone | chalcanthite | blue | stone | blueness | rock | bighead | tinker
mop up | windup | mop | up | swab | thistledown | sandman | meteor
sweat suit | sweats | sweat | suit | perspiration | garment | billow | lambchop
diseased person | sufferer | diseased | person | morbid | individual | rhizoid | overheating
dance hall | ballroom | dance | hall | art | hallway | encyclopedist | hexapod
straw man | figurehead | straw | man | male | imprint | cussedness | chapatti
marijuana cigarette | reefer | marijuana | cigarette | marihuana | cigaret | evening | festering
comb jelly | ctenophore | comb | jelly | device | gelatin | genome | ventriculus
fibre bundle | fasciculus | fibre | bundle | fiber | package | coumarone | yellowness
rotary motion | rotation | rotary | motion | circle | gesture | rifling | bug
estrogen antagonist | tamoxifen | estrogen | antagonist | oestrogen | adversary | colonisation | headliner
ash bin | ashcan | ash | bin | residue | container | tetroxide | amateurishness
common mood | indicative | common | mood | park | temper | clobber | normality
disk shape | circularity | disk | shape | disc | form | residuum | paragon
typographical error | misprint | typographical | error | typographic | mistake | mescaline | hemothorax
bean curd | tofu | bean | curd | legume | foodstuff | sugarcane | meadowlark
data processor | computer | data | processor | information | business | folktale | dupery
gym shoe | sneaker | gym | shoe | gymnasium | footwear | melena | plaiter
cubic meter | kiloliter | cubic | meter | metre | parallelopiped | semiconductor | swap
movie maker | filmmaker | movie | maker | film | shaper | ontogenesis | sensitisation
polyurethane foam | polyfoam | polyurethane | foam | polyurethan | froth | carping | forwardness
working man | workman | working | man | workings | male | ashcan | joy
dirty word | vulgarism | dirty | word | soiled | astragal | hiding | neck
hack driver | taxidriver | hack | driver | drudge | operator | speeding | traditionalism
rich person | have | rich | person | people | individual | candle | slippage
physical attraction | concupiscence | physical | attraction | force | tracery | unicyclist | retrieval
empty tomb | cenotaph | empty | tomb | container | grave | tragedienne | parochialism
swimming costume | swimsuit | swimming | costume | swim | attire | aggressiveness | arrowsmith
book seller | bookdealer | book | seller | publication | marketer | carrack | alalia
governing body | governance | governing | body | government | technobabble | ermine | boot
shoulder blade | scapula | shoulder | blade | leaf | oleoresin | agnathan | salpingectomy
data point | datum | data | point | information | component | blanket | thespian
mutual opposition | polarity | mutual | opposition | common | resistance | ardour | galbanum
body snatcher | ghoul | body | snatcher | thief | convict | tracer | senna
smoked haddock | finnan | smoked | haddock | fish | extravaganza | accoucheur | conference
synonym finder | thesaurus | synonym | finder | word | seeker | boldface | inflaming
intelligence agent | operative | intelligence | agent | ability | extrasystole | instinct | alcoholism
celestial equator | equinoctial | celestial | equator | heavenly | lacrimator | foolhardiness | hermaphrodite
skirt chaser | masher | skirt | chaser | pursuer | ratan | paeony | tope
crack addict | binger | crack | addict | cleft | nut | catabolism | filtrate
feudal system | feudalism | feudal | system | feudalistic | instrumentality | wasting | bombardon
better half | spouse | better | half | good | verticality | incurability | stallion
caisson disease | bends | caisson | disease | coffer | illness | rescission | discina
public presentation | performance | public | presentation | populace | ceremony | passenger | partner
virgin birth | parthenogenesis | virgin | birth | innocent | beginning | type | justiciar
auditory sense | audition | auditory | sense | audile | awareness | allotrope | tahini
computing device | computer | computing | device | engineering | instrumentality | crudity | toothbrush
burial site | cemetery | burial | site | entombment | tract | pel | bulbul
boob tube | telly | boob | tube | dumbbell | tubing | hypnotism | fluting
violent death | killing | violent | death | decease | megasporangium | storybook | mourner
wine steward | sommelier | wine | steward | vino | fiduciary | retrospective | paleoecology
human dynamo | powerhouse | human | dynamo | homo | generator | ogress | phenacomys
picket fence | paling | picket | fence | lookout | fencing | hagiographer | bustle
physical body | bod | physical | body | shrublet | muskiness | annoying | quadratic
muscular structure | musculature | muscular | structure | construction | patrial | pallbearer | rockfish
bedding plant | bedder | bedding | plant | bedclothes | works | mill | bunko
loaf sugar | sugarloaf | loaf | sugar | bread | sweetening | traditionality | depth
schizophrenic psychosis | schizophrenia | schizophrenic | psychosis | psychotic | etagere | hospitality | deadbeat
elevator boy | liftman | elevator | boy | lift | male | filter | meltdown
wetting agent | wetter | wetting | agent | dockyard | publicity | monkfish | embodiment
opposite number | counterpart | opposite | number | antonym | figure | brainchild | sprig
taxi rank | taxistand | taxi | rank | cab | line | strikeout | location
oral cavity | mouth | oral | cavity | viva | pit | squeegee | intolerance
young woman | girl | young | woman | offspring | female | hairtail | department
dairy cattle | milcher | dairy | cattle | farm | cows | caryatid | mortarboard
sketch pad | sketchbook | sketch | pad | study | tablet | microbe | hardball
herb tea | herbal | herb | tea | beverage | synergist | lifeblood | orifice
diametrical opposition | antipodal | diametrical | opposition | diametral | resistance | gambol | professional
letter writer | correspondent | letter | writer | missive | author | rep | chemosynthesis
lower jaw | mandible | lower | jaw | berth | bone | mine | grub
food waste | garbage | food | waste | nutrient | material | invisibleness | harborage
pitch contour | intonation | pitch | contour | tablecloth | shufti | countermove | beachfront
echo sounding | echolocation | echo | sounding | reverberation | depth | falangist | neighbor
drunken revelry | debauch | drunken | revelry | bibulous | revel | neologist | entremets
playground ball | softball | playground | ball | area | potash | swordplay | bellybutton
folk ballad | folksong | folk | ballad | folks | lay | conciseness | alocasia
burlap bag | gunnysack | burlap | bag | gunny | container | tremolo | farmhouse
strong point | forte | strong | point | component | hairpiece | hairline | hake
military rank | paygrade | military | rank | force | line | abomination | stockpile
back talk | sass | back | talk | dorsum | talking | coulter | apogee
concrete representation | concretism | concrete | representation | paving | content | rug | sovereign
greater omentum | caul | greater | omentum | peritoneum | misreading | stipulation | demonstration
air cell | alveolus | air | cell | gas | compartment | ossicle | snuffers
herbal therapy | phytotherapy | herbal | therapy | tea | boxcar | kidskin | hovel
baseball player | ballplayer | baseball | player | participant | cobblers | suit | adulteress
stochastic variable | variate | stochastic | variable | thing | malingerer | conception | artist
sales representative | salesperson | sales | representative | income | negotiator | tupelo | picturesqueness
grade insignia | chevron | grade | insignia | class | badge | visitation | tolbooth
greenish blue | aqua | greenish | blue | green | blueness | shopaholic | bebop
punch bag | punchball | punch | bag | clout | container | warthog | sporulation
water gun | squirter | water | gun | liquid | weapon | resuscitator | stolon
duck hunting | ducking | duck | hunting | hunt | loasa | locality | silt
concurrent execution | multiprogramming | concurrent | execution | coincident | executing | chromate | decay
snake pit | hell | snake | pit | serpent | cavity | decubitus | moray
tree farmer | arboriculturist | tree | farmer | husbandman | aliment | lighterage | blessing
plasminogen activator | urokinase | plasminogen | activator | plasmin | substance | individualist | ignitor
home ground | habitat | home | ground | place | land | spring | temporality
silk cotton | kapok | silk | cotton | fabric | complacence | renouncement | quintal
fishing net | fishnet | fishing | net | sportfishing | internet | dairyman | heptane
back end | backside | back | end | dorsum | terminal | asterion | mastalgia
spontaneous generation | abiogenesis | spontaneous | generation | coevals | cenotaph | oreo | lager
retirement fund | superannuation | retirement | fund | status | money | angelim | contemporaries
soya milk | soymilk | soya | milk | soy | beverage | zayin | urinal
plot line | storyline | plot | line | game | formation | balloonist | beanstalk
stick insect | walkingstick | stick | insect | implement | arthropod | proprietary | forgery
water pistol | squirter | water | pistol | liquid | handgun | armory | shoestring
old times | langsyne | old | times | past | mallee | insurer | mastication
burial ground | cemetery | burial | ground | entombment | land | artifact | lithography
hybrid vigor | heterosis | hybrid | vigor | word | energy | discipleship | tablespoon
manufacturing plant | factory | manufacturing | plant | fabrication | works | coign | disease
picture taking | photography | picture | taking | image | pickings | catamenia | turbot
train dispatcher | yardmaster | train | dispatcher | starter | bench | gastroscope | rente
hot pants | horniness | hot | pants | bloomers | decolonisation | llano | baptistry
disorganized schizophrenia | hebephrenia | disorganized | schizophrenia | disorganised | psychosis | collaborationist | worthiness
cave dweller | caveman | cave | dweller | inhabitant | jag | milliwatt | regeneration
exploratory survey | scouting | exploratory | survey | explorative | study | overexposure | perversion
lower status | inferiority | lower | status | berth | position | ad | conversationist
canal boat | narrowboat | canal | boat | channel | vessel | bellbird | waistline
hair tonic | hairdressing | hair | tonic | attache | lozenge | antiphonary | accumulator
electrical storm | thunderstorm | electrical | storm | sunbonnet | tack | cooperativeness | shoveler
velvet plant | mullein | velvet | plant | fabric | works | circumduction | jot
phrase structure | syntax | phrase | structure | construction | artifact | incompetent | chlorite
locust bean | carob | locust | bean | legume | napkin | gimcrack | platelet
scaphoid bone | navicular | scaphoid | bone | os | raiser | niggard | hyperacusis
starting time | commencement | starting | time | start | clip | acquisitiveness | hermeneutics
call number | pressmark | call | number | telephone | figure | chaplain | drugging
fruit drink | ade | fruit | drink | helping | worth | woofer | adactyly
social worker | caseworker | social | worker | sociable | person | tactician | linguica
carpet pad | underlay | carpet | pad | rug | tablet | astilbe | androgyny
camera operator | cameraman | camera | operator | function | matriarch | haziness | arles
revenue enhancement | tax | revenue | enhancement | gross | sweetening | beau | ameer
small letter | lowercase | small | letter | little | missive | ploughman | debt
toilet facility | restroom | toilet | facility | lavatory | installation | mange | descensus
delivery boy | deliveryman | delivery | boy | bringing | male | noise | quattrocento
embroidery frame | tambour | embroidery | frame | embellishment | framework | mastermind | aura
higher rank | seniority | higher | rank | line | rotunda | lyssavirus | hubris
wrist bone | carpal | wrist | bone | carpus | os | amazement | praya
milk sickness | trembles | milk | sickness | beverage | illness | bubbler | superego
country people | countryfolk | country | people | state | group | plasminogen | widening
radar beacon | racon | radar | beacon | radiolocation | career | elbow | insect
auditory modality | audition | auditory | modality | audile | mode | vespertilionid | people
wooden shoe | sabot | wooden | shoe | footwear | hasp | roundsman | gouger
theoretical account | model | theoretical | account | theoretic | history | prodding | interference
hotel manager | hotelier | hotel | manager | building | director | mucoid | cistern
starting motor | starter | starting | motor | start | machine | variegation | orderliness
lady beetle | ladybug | lady | beetle | woman | insect | nisus | subversiveness
hemorrhagic septicemia | pasteurellosis | hemorrhagic | septicemia | haemorrhagic | septicaemia | bulldozer | cager
street person | dosser | street | person | thoroughfare | individual | sectarianism | paraquat
good story | funny | good | story | advantage | narrative | sportsmanship | cloudburst
sport coat | blazer | sport | coat | athletics | overgarment | herbarium | archaebacterium
breathing space | breather | breathing | space | respiration | infinite | stockholding | sparseness
football player | footballer | football | player | participant | balmoral | bench | brain
wood nymph | dryad | wood | nymph | wagon | chebab | voluptuousness | censure
absorption factor | absorptivity | absorption | factor | sorption | cause | gastronome | malachite
safety rail | guardrail | safety | rail | condition | railing | boomer | chill
air current | wind | air | current | gas | sedum | sudorific | bag
bawling out | castigation | bawling | out | wailing | failure | teetotalism | coulisse